name=姓名
general=一般的
sensitive=敏感的
questionable=可疑的
explicit=明确的
1girl=1个女孩
solo=独自的
long hair=长发
breasts=乳房
looking at viewer=看着观众
blush=脸红
smile=微笑
short hair=短发
open mouth=张开嘴
bangs=刘海
blue eyes=蓝眼睛
multiple girls=多个女孩
skirt=裙子
blonde hair=金头发
large breasts=大乳房
simple background=简单的背景
brown hair=棕色的头发
shirt=衬衫
black hair=黑发
hair ornament=发饰
red eyes=红眼睛
thighhighs=高抬腿
gloves=手套
long sleeves=长袖
1boy=1男孩
hat=有
white background=白色背景
dress=裙子
bow=弓
ribbon=丝带
navel=脐
holding=保持
2girls=2个女孩
animal ears=动物耳朵
cleavage=分裂
hair between eyes=两眼之间的头发
bare shoulders=露肩
twintails=双马尾
brown eyes=棕色的眼睛
jewelry=珠宝
medium breasts=中等乳房
sitting=坐着
very long hair=很长的头发
closed mouth=闭嘴
underwear=内衣
nipples=乳头
school uniform=校服
green eyes=绿眼睛
blue hair=蓝头发
standing=常设
purple eyes=紫色的眼睛
collarbone=锁骨
panties=内裤
jacket=夹克
tail=尾巴
monochrome=单色
swimsuit=泳装
full body=全身
closed eyes=闭上眼睛
hair ribbon=发带
yellow eyes=黄眼睛
white shirt=白衬衫
upper body=上半身
ponytail=马尾辫
weapon=武器
pink hair=粉红色的头发
purple hair=紫色的头发
ass=是
braid=编织
flower=花
comic=漫画
ahoge=高
white hair=白色的头发
short sleeves=短袖
:d=:d
hetero=异类
hair bow=发夹
greyscale=灰阶
grey hair=头发花白
male focus=男性焦点
heart=心
pantyhose=连裤袜
sidelocks=侧锁
bikini=比基尼
thighs=大腿
nude=裸体
red hair=红发
multicolored hair=五颜六色的头发
cowboy shot=牛仔射击
sweat=汗
pleated skirt=百褶裙
hairband=发带
earrings=耳环
small breasts=小乳房
boots=靴子
outdoors=户外
lying=说谎
censored=审查
frills=多余的装饰
parted lips=分开的嘴唇
detached sleeves=袖子分离
one eye closed=一只眼睛闭着
food=食物
japanese clothes=日本衣服
green hair=绿色的头发
multiple boys=多个男孩
open clothes=打开衣服
wings=翅膀
necktie=领带
horns=牛角
sky=天空
penis=阴茎
shoes=鞋
glasses=眼镜
shorts=短裤
barefoot=赤脚
teeth=牙齿
pussy=猫
serafuku=色拉服
sleeveless=无袖的
solo focus=只是专注
alternate costume=备用服装
choker=项圈
day=天
tongue=舌头
pointy ears=尖耳朵
black gloves=黑手套
socks=袜子
hairclip=发夹
elbow gloves=肘部手套
fang=放
midriff=膈
striped=有条纹的
puffy sleeves=蓬松的袖子
shiny=闪亮的
collared shirt=有领衬衫
belt=腰带
looking back=回头看
pants=裤子
sword=剑
artist name=艺术家姓名
black thighhighs=黑色长筒袜
cloud=云
indoors=在室内
virtual youtuber=虚拟YouTuber
cat ears=猫耳朵
tears=眼泪
white gloves=白手套
hand up=举手
signature=签名
hair flower=发花
dark skin=暗黑皮肤
3girls=3个女孩
spread legs=张开双腿
cum=如何
hood=兜帽
2boys=2男孩
sex=性别
tongue out=伸出舌头
miniskirt=迷你裙
wide sleeves=宽袖
blunt bangs=钝刘海
on back=背部
fingerless gloves=露指手套
bowtie=领结
black skirt=黑色裙子
medium hair=中长发
pink eyes=粉红色的眼睛
armpits=腋下
sailor collar=水手领
kimono=和服
grey background=灰色背景
water=水
necklace=项链
off shoulder=脱肩
stomach=胃
bag=包
hair bun=发髻
chibi=赤壁
clothes lift=衣服电梯
twitter username=Twitter用户名
from behind=从后面
star (symbol)=星号（符号）
scarf=围巾
cape=岬
nail polish=指甲油
black footwear=黑鞋
holding weapon=拿着武器
bra=好的
white dress=白色礼服
orange hair=橙色的头发
yuri=尤里
sweatdrop=汗珠
armor=盔甲
rabbit ears=兔子耳朵
mole=痣
white panties=白色内裤
hair over one eye=一只眼睛上的头发
grin=咧嘴一笑
blurry=模糊的
huge breasts=巨大的乳房
looking at another=看着另一个
:o=:O
uniform=制服
black eyes=黑眼睛
apron=围裙
character name=角色名字
vest=背心
black dress=黑裙子
mosaic censoring=马赛克审查
arm up=武装起来
vaginal=阴道
red bow=红色领结
high heels=高跟鞋
shiny hair=闪亮的头发
twin braids=双辫子
arms up=举起手来
flat chest=平胸
side ponytail=侧马尾辫
collar=衣领
bracelet=手镯
feet=脚
covered nipples=遮盖的乳头
from side=从侧面
dated=过时的
two-tone hair=双色头发
aqua eyes=水色眼睛
sweater=毛衣
speech bubble=会话框
white thighhighs=白色长筒袜
english text=英文文本
leotard=紧身衣
open jacket=开夹克
official alternate costume=官方备用服装
red ribbon=红带
dark-skinned female=深色皮肤的女性
two side up=两侧向上
tree=树
cup=杯子
blue sky=蓝天
sketch=草图
puffy short sleeves=蓬松的短袖
lips=嘴唇
blue skirt=蓝色裙子
zettai ryouiki=绝对面积
streaked hair=条纹的头发
coat=外套
black jacket=黑色的夹克
crop top=作物顶部
groin=腹股沟
fingernails=指甲
wet=湿的
v-shaped eyebrows=v型眉
cat tail=猫尾巴
neckerchief=围巾
orange eyes=橙色的眼睛
animal ear fluff=动物耳毛
head tilt=头部倾斜
see-through=透视
gradient=坡度
hand on hip=手放在臀部
gun=枪
legs=腿
one-piece swimsuit=连体泳衣
shiny skin=闪亮的皮肤
sleeves past wrists=袖子过手腕
parted bangs=分开的刘海
looking to the side=看着旁边
pillow=枕头
wrist cuffs=手腕袖口
grey eyes=灰色的眼睛
torn clothes=破衣服
book=书
plaid=格子
black pantyhose=黑色连裤袜
maid=女佣
symbol-shaped pupils=符号形瞳孔
hands up=举手
sash=窗扇
fur trim=毛皮饰边
kneehighs=齐膝
maid headdress=女仆头饰
military=军队
black panties=黑色内裤
cosplay=角色扮演
bare arms=光着胳膊
petals=花瓣
pubic hair=阴毛
black shirt=黑色衬衫
fox ears=狐狸耳朵
loli=改变
gradient background=渐变背景
short shorts=短裤
ascot=阿斯科特
clothing cutout=衣服剪裁
completely nude=完全裸体
dutch angle=荷兰角
eyelashes=睫毛
bar censor=酒吧审查员
mole under eye=眼睛下面的痣
pokemon (creature)=口袋妖怪（生物）
no humans=没有人
bare legs=光腿
window=窗户
open shirt=开衫
sparkle=火花
dress shirt=正装衬衫
kneeling=跪着
sleeveless shirt=无袖上衣
single braid=单辫子
v=在
black headwear=黑色头饰
strapless=无肩带
4girls=4个女孩
bell=钟
hug=拥抱
no bra=不戴胸罩
saliva=唾液
double bun=双重好
black ribbon=黑丝带
uncensored=未经审查
aqua hair=水绿色的头发
bodysuit=连体衣
blood=血
bed=床
hoodie=连帽衫
military uniform=军装
sideboob=侧臂
black bow=黑弓
covered navel=遮住肚脐
tattoo=纹身
gradient hair=渐变头发
skindentation=皮肤凹陷
neck ribbon=颈带
pussy juice=猫汁
profile=轮廓
makeup=化妆品
thigh strap=大腿带
leaning forward=身体前倾
multiple views=多个视图
4koma=4 但是
capelet=披肩
mask=面具
muscular=肌肉发达的
anus=肛门
no panties=没有内裤
witch hat=女巫帽
detached collar=分离领
toes=脚趾
:3=:3
copyright name=版权名称
alternate hairstyle=另类发型
underboob=胸下
night=夜晚
buttons=纽扣
floating hair=漂浮的头发
fruit=水果
sleeveless dress=无袖连衣裙
depth of field=景深
blurry background=模糊的背景
feet out of frame=脚在框架外
headband=头巾
fake animal ears=假动物耳朵
^ ^=^ ^
blue dress=蓝色连衣裙
cameltoe=骆驼趾
cum in pussy=暨在猫
fox tail=狐狸尾巴
swept bangs=扫刘海
shadow=阴影
black bikini=黑色比基尼
red skirt=红裙子
nose blush=鼻红
bottomless=无底的
glowing=发光的
side-tie bikini bottom=侧系带比基尼泳裤
rose=玫瑰
bed sheet=被单
colored skin=有色皮肤
turtleneck=高领毛衣
holding hands=手牵着手
facial hair=胡子
chain=链
headgear=帽子
bird=鸟
pov=扔
siblings=兄弟姐妹
headphones=耳机
ocean=海洋
6+girls=6+女孩
low twintails=低双马尾
heterochromia=异色症
arm support=手臂支撑
animal=动物
halterneck=挂脖
frown=皱眉
leaf=叶子
beret=贝雷帽
white headwear=白色头饰
umbrella=伞
on bed=在床上
one side up=一面朝上
embarrassed=尴尬的
thigh boots=大腿靴
fangs=獠牙
upper teeth only=仅上牙
watermark=水印
from above=从上面
back=后退
highleg=高腿
blue background=蓝色背景
ass visible through thighs=屁股从大腿可见
wavy hair=卷发
garter straps=吊袜带
black choker=黑色项圈
halo=光环
blue bow=蓝弓
scar=瘢痕
white bikini=白色比基尼
on side=一边
plaid skirt=格子裙
chair=椅子
transparent background=透明背景
wariza=瓦里扎
facial mark=面部标记
mouth hold=嘴含住
looking away=看着别处
traditional media=传统媒体
beach=海滩
bandages=绷带
parody=恶搞
female pubic hair=女性阴毛
expressionless=面无表情
brown footwear=棕色鞋
blush stickers=腮红贴
shirt lift=衬衫提升
thick thighs=大腿粗
no shoes=没有鞋子
holding sword=持剑
hair tubes=毛管
chinese clothes=中国衣服
drill hair=钻毛
grabbing=抓住
arms behind back=双臂背后
soles=鞋底
obi=心
heart-shaped pupils=心形瞳孔
eating=吃
clothes pull=衣服拉
looking down=向下看
phone=电话
black shorts=黑色短裤
thigh gap=大腿间隙
black pants=黑裤子
short dress=短裙
topless=裸照
piercing=冲孔
pantyshot=连裤袜
hair intakes=头发摄入量
eyepatch=眼罩
border=边界
skirt lift=裙子升降机
floral print=碎花
stuffed toy=毛绒玩具
bound=边界
formal=正式的
playboy bunny=花花公子兔子
flying sweatdrops=飞行的汗珠
crossed arms=双臂交叉
wavy mouth=波浪嘴
magical girl=魔法少女
erection=勃起
abs=腹肌
moon=月亮
half-closed eyes=半闭眼
leg up=抬腿
from below=从下面
red dress=红色礼服
cleavage cutout=解理切口
sandals=凉鞋
table=桌子
happy=快乐的
sunlight=阳光
oral=口服
cover=覆盖
squatting=蹲着
single hair bun=单发髻
cat=猫
testicles=睾丸
pink background=粉色背景
sunglasses=太阳镜
scrunchie=发带
white footwear=白鞋
dark-skinned male=深色皮肤的男性
underwear only=只有内衣
cum on body=射在身上
trembling=发抖
bob cut=鲍勃切
ring=戒指
bdsm=性虐待
school swimsuit=学校泳装
mob cap=暴徒上限
wolf ears=狼耳
blazer=西装外套
light brown hair=浅棕色的头发
white jacket=白夹克
standing on one leg=单腿站立
sleeping=睡眠
thick eyebrows=浓浓的眉毛
backpack=背包
white skirt=白裙子
demon girl=恶魔女孩
frilled dress=荷叶边连衣裙
eyes visible through hair=透过头发可以看到眼睛
breast grab=乳房抓
cardigan=开襟衫
knee boots=及膝靴
suspenders=吊带裤
hat ribbon=有丝带
crossed legs=盘腿
lingerie=内衣
stuffed animal=填充玩具动物
katana=武士刀
hood down=敞篷下来
;d=;d
3boys=3男孩
bat wings=蝙蝠翅膀
horse ears=马耳朵
helmet=头盔
cloudy sky=多云的天空
cellphone=手机
crying=哭泣
antenna hair=天线毛
own hands together=自己动手
tank top=背心
bottle=瓶子
suit=套装
grass=草
outstretched arms=伸出双臂
cross=叉
bug=漏洞
holding food=拿着食物
fire=火
frilled skirt=荷叶边裙
tiara=皇冠
aged down=老化
polka dot=圆点
feathers=羽毛
breasts out=乳房出来
crossover=交叉
crown=王冠
high ponytail=高马尾辫
looking up=仰望
black hairband=黑色发带
bent over=弯腰
undressing=脱衣服
blue shirt=蓝衬衫
white bow=白弓
5girls=5个女孩
straddling=跨立
light smile=浅笑
knife=刀
pectorals=胸肌
x hair ornament=x发饰
plant=植物
couple=夫妻
denim=牛仔布
on stomach=在肚子上
wing collar=翼领
> <=> <
robot=机器人
white flower=白色的花
hair bobbles=头发泡泡
fellatio=口交
outstretched arm=伸出的手臂
sharp teeth=锋利的牙齿
blue ribbon=蓝丝带
lipstick=口红
tan=棕褐色
girl on top=女孩在上面
cat girl=猫女
short twintails=短双马尾
lifted by self=自己举起
bondage=束缚
curtains=窗帘
white socks=白袜子
letterboxed=信箱
animal print=动物印花
muscular male=肌肉男
spiked hair=尖刺的头发
pointing=指向
pink bow=粉色蝴蝶结
juliet sleeves=朱丽叶袖子
monster girl=怪物女孩
sex from behind=从后面做爱
slit pupils=狭缝瞳孔
polearm=极臂
all fours=四肢着地
blue jacket=蓝色夹克
sisters=姐妹
^^^=^^^
frilled sleeves=褶边袖
hand on own chest=手放在自己的胸口
red necktie=红领带
blue sailor collar=蓝色水手领
crescent=新月
?=?
staff=职员
black background=黑色背景
clenched teeth=咬紧牙关
panty pull=内裤拉
cherry blossoms=樱花
head wings=头翅膀
horse girl=马女
brooch=胸针
goggles=风镜
demon horns=恶魔之角
towel=毛巾
blouse=女式衬衫
shaded face=阴影脸
red flower=红花
green skirt=绿色的裙子
fox girl=狐女郎
ground vehicle=地面车辆
cover page=封面
black bra=黑色文胸
elf=小精灵
bike shorts=自行车短裤
otoko no ko=男生
wind=风
casual=随意的
black socks=黑袜子
loafers=乐福鞋
t-shirt=T恤
motion lines=运动线
shoulder armor=肩甲
gauntlets=护手
no pants=没有裤子
building=建筑
pink panties=粉色内裤
messy hair=凌乱的头发
single thighhigh=单人大腿
multiple tails=多条尾巴
kiss=吻
wristband=腕带
group sex=群交
breast press=乳房按压
between breasts=乳房之间
surprised=吃惊
striped panties=条纹内裤
hat bow=帽子蝴蝶结
gem=宝石
butterfly=蝴蝶
red footwear=红鞋
red shirt=红衬衫
sheath=鞘
sneakers=运动鞋
rabbit tail=兔子尾巴
tassel=流苏
instrument=乐器
box=盒子
ear piercing=打耳洞
drooling=流口水
fishnets=渔网
ribbon trim=丝带装饰
clenched hand=紧握的手
sex toy=性玩具
red bowtie=红色领结
third eye=第三只眼睛
skirt set=裙子套装
child=孩子
hakama=还有
pale skin=皮肤苍白
portrait=肖像
musical note=音符
revealing clothes=暴露衣服
rope=绳索
star (sky)=星星（天空）
wet clothes=湿衣服
steam=蒸汽
candy=糖果
pink dress=粉红色的裙子
genderswap=性别互换
facial=面部的
demon tail=恶魔尾巴
dog ears=狗耳朵
anal=肛门
foreshortening=缩短
holding gun=拿着枪
nature=自然
covering=覆盖
adapted costume=改装服装
side-tie panties=侧系带内裤
black nails=黑指甲
night sky=夜空
christmas=圣诞节
breath=呼吸
ejaculation=射精
veil=面纱
scenery=风景
armband=臂章
peaked cap=尖顶帽
waist apron=腰围裙
lace trim=花边饰边
convenient censoring=方便审查
white apron=白围裙
couch=长椅
arms behind head=双臂放在脑后
china dress=中国服饰
bandaid=绷带
holding cup=拿着杯子
black leotard=黑色紧身衣
male pubic hair=男性阴毛
interlocked fingers=十指相扣
mole under mouth=嘴下痣
microphone=麦克风
bridal gauntlets=新娘手套
bara=仅有的
strapless dress=露肩礼服
tokin hat=铁拳帽子
yaoi=矢追
straight hair=直发
front-tie top=前系带上衣
bow panties=蝴蝶结内裤
lace=蕾丝
mecha=机甲
hakama skirt=还有一条裙子
hand fan=手扇
white ribbon=白丝带
glowing eyes=发光的眼睛
anger vein=怒脉
...=...
breasts apart=分开乳房
no headwear=没有头饰
hair over shoulder=肩上的头发
clothes writing=衣服写字
jingle bell=叮铃铃
baseball cap=棒球帽
yellow background=黄色背景
hair flaps=发瓣
string bikini=系带比基尼
feathered wings=有羽毛的翅膀
hooded jacket=连帽外套
cum on breasts=暨在乳房上
bikini top only=仅比基尼上衣
red headwear=红色头饰
twin drills=双钻
facing viewer=面对观众
skin tight=皮肤紧致
multiple penises=多个阴茎
semi-rimless eyewear=半框眼镜
red nails=红指甲
bright pupils=明亮的瞳孔
black necktie=黑色领带
web address=网址
:<=:<
angry=生气的
grey shirt=灰色衬衫
cloak=披风
eyewear on head=头上的眼镜
motor vehicle=摩托车
red background=红色背景
claws=爪子
side braid=侧辫
wolf tail=狼尾巴
pelvic curtain=盆腔帘
light particles=光粒子
light purple hair=淡紫色的头发
multicolored clothes=五颜六色的衣服
carrying=携带
micro bikini=微比基尼
knees up=跪下
smartphone=手机
corset=紧身胸衣
tentacles=触手
index finger raised=食指举起
clothing aside=衣服放在一边
purple dress=紫色连衣裙
extra ears=额外的耳朵
rifle=步枪
striped thighhighs=条纹长筒袜
white border=白色边框
mary janes=玛丽简斯
beard=胡须
paizuri=paizuri
vertical stripes=竖条纹
red jacket=红色夹克
:p=:p
red neckerchief=红领巾
short hair with long locks=长发短发
scar on face=脸上的伤疤
tareme=我们说
neck bell=颈铃
licking=舔
furry=毛茸茸的
single horn=单喇叭
strap slip=带子打滑
finger to mouth=指到嘴
pom pom (clothes)=pom pom（衣服）
snow=雪
french braid=法式辫子
close-up=特写
androgynous=雌雄同体的
1other=1其他
areola slip=乳晕滑动
forehead=前额
puffy nipples=浮肿的乳头
buckle=扣上
horse tail=马尾巴
two-tone background=双色背景
full moon=满月
eye contact=眼神接触
pink flower=粉红色的花
tsurime=吊眼
yellow bow=黄弓
gift=礼物
seiza=整治
upskirt=掀裙
blue bikini=蓝色比基尼
pink nails=粉红色的指甲
santa hat=圣诞帽
genderswap (mtf)=性别互换 (mtf)
lens flare=镜头光晕
skin fang=skin放
spikes=尖刺
armlet=臂章
hand on own face=手放在自己的脸上
desk=桌子
between legs=两腿之间
brown gloves=棕色手套
side slit=侧缝
handgun=手枪
camisole=吊带背心
wading=涉水
faceless=无脸
low ponytail=低马尾辫
restrained=克制的
pendant=期间
plate=盘子
dual persona=双人
masturbation=自慰
highleg leotard=紧身连衣裤
spoken heart=口语心
curvy=弯曲的
green bow=绿弓
maid apron=女仆围裙
alcohol=酒精
after sex=做爱后
grey skirt=灰色裙子
handjob=手工作业
sleeves rolled up=挽起袖子
red gloves=红手套
o-ring=O型圈
heavy breathing=沉重的呼吸
abyssal ship=深海船
eyeshadow=眼影
ribbed sweater=罗纹毛衣
drinking glass=水杯
hair scrunchie=发圈
cowgirl position=女牛仔位置
cross-laced footwear=交叉系带鞋
blue headwear=蓝色头饰
broom=扫帚
ball=球
puffy long sleeves=蓬松的长袖
sleeves past fingers=袖子过手指
clenched hands=握紧的手
hood up=罩起来
cropped legs=七分腿
floating=漂浮的
wide hips=宽臀
forest=森林
low-tied long hair=低领长发
breast hold=抱胸
smoke=抽烟
zipper=拉链
dress lift=礼服电梯
tray=托盘
personification=拟人化
headwear removed=移除头饰
high heel boots=高跟靴
partially submerged=部分淹没
headset=耳机
halloween=万圣节
hair rings=发圈
legs up=双腿抬起
half updo=半髻
doujin cover=同人儿童版
pink skirt=粉色裙子
starry sky=星空
colored sclera=有色巩膜
pencil skirt=铅笔裙
strapless leotard=露肩紧身连衣裤
single glove=单手套
machinery=机械
clothed sex=穿衣服的性
blue nails=蓝指甲
backlighting=逆光
freckles=雀斑
tearing up=撕毁
reflection=反射
tanlines=驼色系
fish=鱼
sweater vest=毛衣背心
holding book=拿着书
arm behind back=背后的手臂
arm at side=手臂放在一边
santa costume=圣诞老人服装
large pectorals=宽阔的胸肌
spot color=专色
flying=飞行
white bra=白色文胸
asymmetrical legwear=不对称裤袜
brown background=棕色背景
panties under pantyhose=连裤袜下的内裤
nontraditional miko=非传统巫女
red bikini=比基尼回复了
happy birthday=生日快乐
cropped jacket=短款夹克
long fingernails=长指甲
!=!
kemonomimi mode=兽耳模式
sailor dress=水手服
clothed female nude male=穿衣女裸男
walking=步行
fingering=指法
science fiction=科幻小说
rain=雨
white pantyhose=白色连裤袜
garter belt=吊袜腰带
frilled bikini=褶边比基尼
dual wielding=双持
6+boys=6+男孩
pink ribbon=粉红丝带
cuffs=袖口
red-framed eyewear=红框眼镜
dragon horns=龙角
epaulettes=肩章
black wings=黑翅膀
bubble=气泡
demon wings=恶魔之翼
thong=丁字裤
legs apart=双腿分开
teacup=茶碗
condom=避孕套
veins=静脉
crossdressing=变装
ribbon-trimmed sleeves=丝带边袖
holding phone=拿着电话
gym uniform=体操服
short ponytail=短马尾辫
arm behind head=手臂放在脑后
cake=蛋糕
out of frame=框架外
innertube=内管
oni horns=鬼角
contrapposto=对比
naughty face=调皮的脸
green background=绿色背景
alternate breast size=备用乳房大小
purple background=紫色背景
black-framed eyewear=黑框眼镜
rape=强奸
beads=珠子
knee up=膝盖向上
hat ornament=帽子饰品
one-hour drawing challenge=一小时绘画挑战
fur collar=毛领
blue shorts=蓝色短裤
outside border=外边界
thighband pantyhose=大腿连裤袜
meme=模因
bowl=碗
toenails=脚趾甲
cumdrip=射精
blue flower=蓝花
denim shorts=牛仔短裤
curly hair=卷发
track jacket=运动夹克
black sailor collar=黑色水手领
light blush=淡淡的腮红
school bag=书包
pocket=口袋
spread pussy=传播猫
toned=调子
pink shirt=粉色衬衫
doggystyle=后入式
white sleeves=白色袖子
:q=:q
hand in own hair=手挽自己的头发
spoken ellipsis=省略号
empty eyes=空洞的眼睛
purple skirt=紫色裙子
crying with eyes open=睁着眼睛哭
goggles on head=头上的护目镜
green dress=绿色连衣裙
4boys=4个男孩
bulge=凸
sun hat=太阳帽
cum in mouth=暨在嘴里
lolita fashion=洛丽塔时尚
shiny clothes=闪亮的衣服
pauldrons=护肩
outline=大纲
buruma=布鲁玛
hand on another's head=把手放在别人的头上
futanari=双性人成
topless male=裸照男
under-rim eyewear=下框眼镜
frilled apron=褶边围裙
white pupils=白色瞳孔
skull=颅骨
jitome=夹具眼睛
gold trim=金色饰边
long legs=大长腿
sunset=日落
monster=怪物
frilled shirt collar=荷叶边衬衫领
emphasis lines=强调线
hands on hips=双手叉腰
high-waist skirt=高腰半身裙
new year=新年
shield=盾
aged up=老了
animal hands=动物手
mole on breast=乳房上的痣
spear=矛
asymmetrical hair=不对称的头发
female masturbation=女性自慰
v arms=v 武器
single earring=单耳环
running=跑步
dog=狗
angel wings=天使的翅膀
long skirt=长裙
breasts squeezed together=乳房挤在一起
competition swimsuit=比赛泳衣
watch=手表
dog tail=狗尾巴
black belt=黑带
black serafuku=返回 Sefuku
faceless male=无脸男
legs together=双腿并拢
ice=冰
white skin=白皮肤
blue footwear=蓝色鞋类
o o=的
= === =
ass grab=屁股抢
impossible clothes=不可能的衣服
purple bow=紫弓
head rest=头枕
red scarf=红领巾
teddy bear=玩具熊
striped bikini=条纹比基尼
poke ball=戳球
brown skirt=棕色裙子
pouch=小袋
minigirl=迷你女孩
+ +=+ +
white sailor collar=白色水手领
blue theme=蓝色主题
plump=丰满
ghost=鬼
cigarette=香烟
hat removed=脱下帽子
hand in pocket=手插在口袋里
brown pantyhose=棕色连裤袜
bespectacled=戴眼镜的
braided ponytail=编织马尾辫
age difference=年龄差
tress ribbon=丝带
paw pose=爪子姿势
open coat=开大衣
rabbit=兔子
sarashi=接触
black coat=黑色外套
knees together feet apart=双膝并拢双脚分开
shawl=披肩
folded ponytail=折叠马尾辫
turret=炮塔
black vest=黑色背心
blue one-piece swimsuit=蓝色连体泳衣
popsicle=棒冰
hand between legs=两腿之间的手
hair down=头发掉下来
high collar=高领
drinking straw=吸管
yellow shirt=黄色衬衫
sheathed=护套
dragon girl=龙女
yukata=浴衣
brown jacket=棕色夹克
twins=双胞胎
bow (weapon)=弓（武器）
robe=长袍
oni=他们
thought bubble=思想泡泡
upside-down=倒挂
jeans=牛仔裤
serious=严肃的
yellow ribbon=黄丝带
object insertion=对象插入
striped shirt=条纹衬衫
military hat=军帽
injury=受伤
smirk=傻笑
circlet=圆环
light rays=光线
lollipop=棒糖
blue panties=蓝色内裤
@ @=@ @
;)=;)
tabard=战袍
missionary=传教士
blue necktie=蓝色领带
mini hat=迷你有
page number=页码
patreon username=用户名
bouncing breasts=弹跳的乳房
red rose=红玫瑰
eyebrows hidden by hair=眉毛被头发遮住
hoop earrings=圈形耳环
pajamas=睡衣
wide-eyed=睁大眼睛
threesome=三人行
dakimakura (medium)=抱枕（关节）
crystal=水晶
lantern=灯笼
blurry foreground=前景模糊
white hairband=白色发带
butt crack=屁股裂纹
sideburns=鬓角
mature female=成熟女性
striped bow=条纹蝴蝶结
white shorts=白色短裤
tentacle hair=触手毛
contemporary=当代的
sports bra=运动好
ofuda=护符
water drop=水滴
black bowtie=黑色领结
top hat=礼帽
hairpin=簪
breastplate=胸甲
partially fingerless gloves=部分露指手套
blood on face=脸上有血
:t=:t
wooden floor=木地板
height difference=身高差
rock=岩石
belt buckle=皮带扣
handbag=手提包
| |=| |
jumping=跳跃
snowing=下雪
colored eyelashes=彩色睫毛
mirror=镜子
mug=马克杯
crossed bangs=交叉刘海
chocolate=巧克力
hug from behind=从背后拥抱
white kimono=白色和服
green jacket=绿夹克
outstretched hand=伸出的手
star hair ornament=明星发饰
bouquet=花束
chopsticks=筷子
paper=纸
object hug=对象拥抱
shoulder bag=单肩包
pink lips=粉红色的嘴唇
sportswear=运动装
stairs=楼梯
full-face blush=全脸腮红
cropped torso=裁剪躯干
colored inner hair=有色内毛
oekaki=绘画
holding umbrella=撑伞
animal hood=动物罩
one eye covered=一只眼睛被遮住
mountain=山
glint=闪烁
covering breasts=覆盖乳房
raised eyebrows=扬起眉毛
city=城市
mature male=成熟的男性
underwater=水下
vibrator=振动器
valentine=情人节
wedding dress=婚纱
multicolored eyes=五颜六色的眼睛
enmaided=被奴役
open book=打开书
adjusting clothes=调整衣服
meme attire=甚至吸引
miko=巫女
backless outfit=露背装
panties aside=内裤放在一边
bandaged arm=包扎的手臂
turtleneck sweater=高领毛衣
bloomers=灯笼裤
doll=玩具娃娃
cum on hair=暨在头发上
sign=符号
waving=挥手
borrowed character=借来的字
pout=噘
snake=蛇
hair bell=发铃
fighting stance=战斗姿态
forehead mark=额头印记
motion blur=运动模糊
realistic=实际的
yellow flower=黄花
ice cream=冰淇淋
strawberry=草莓
skirt hold=裙撑
aircraft=飞机
white pants=白裤子
orange bow=橙色蝴蝶结
card=卡片
grey jacket=灰色夹克
spoon=勺子
!?=!?
headpiece=头巾
panties around one leg=一条腿周围的内裤
mouse ears=老鼠耳朵
brother and sister=兄弟姐妹
leash=皮带
pink bra=粉红好
nose=鼻子
nurse cap=护士帽
hands in pockets=双手插在口袋里
front-tie bikini top=正面系带比基尼上衣
hair tie=发带
text focus=文本焦点
fence=栅栏
short eyebrows=短眉毛
green headwear=绿色头饰
bandana=头巾
white leotard=白色紧身衣
visor cap=遮阳帽
fantasy=幻想
round eyewear=圆形眼镜
green shirt=绿色衬衫
mustache=胡子
round teeth=圆牙
holding staff=控股员工
center opening=中心开口
clitoris=阴蒂
sand=沙
hime cut=姬切
drink=喝
on floor=在地上
eighth note=八分音符
covering mouth=捂嘴
can=能
anklet=脚链
mouth mask=口罩
blue skin=蓝色皮肤
overflow=溢出
orange background=橙色背景
dildo=假阳具
palm tree=棕榈树
door=门
scar across eye=眼睛上的疤痕
geta=能
purple flower=紫花
dragon=龙
rabbit girl=兔女郎
top-down bottom-up=自上而下 自上而下
fake tail=假尾巴
asymmetrical bangs=不对称的刘海
sitting on person=坐在人身上
stubble=茬
furry female=毛茸茸的女性
furrowed brow=皱着眉头
dragon tail=龙尾
interracial=跨种族
fork=叉
antennae=触角
alternate color=交替颜色
anchor symbol=锚符号
sailor hat=水手帽
arrow (projectile)=箭头（弹丸）
off-shoulder dress=露肩连衣裙
music=音乐
card (medium)=卡（中）
white wings=白色的翅膀
blindfold=眼罩
long dress=长裙
licking lips=舔嘴唇
white one-piece swimsuit=白色连体泳衣
arrow (symbol)=箭头（符号）
sharp fingernails=锋利的指甲
adjusting hair=调整头发
double v=双v
green ribbon=绿丝带
frog hair ornament=青蛙发饰
spread arms=张开双臂
arms at sides=双臂在两侧
winter uniform=冬季制服
camera=相机
wand=棍棒
arched back=弓背
jacket on shoulders=肩上的夹克
hip focus=臀部焦点
veiny penis=静脉阴茎
brown headwear=棕色头饰
heart hair ornament=心形发饰
head out of frame=头出框架
zoom layer=缩放图层
straw hat=草帽
apple=苹果
folding fan=折扇
labcoat=实验工作服
railing=栏杆
purple ribbon=紫丝带
blanket=毯子
gag=插科打诨
sun=太阳
hanging breasts=悬垂的乳房
pink footwear=粉红色的鞋
black one-piece swimsuit=黑色连体泳衣
yokozuwari=侧身坐着
emblem=徽
sunflower=向日葵
arm warmers=暖手器
pasties=馅饼
dog girl=狗女孩
groping=摸索
muscular female=肌肉女
shota=翔太
android=安卓
alternate hair length=交替的头发长度
horizon=地平线
lowleg=小腿
branch=分支
dot nose=点鼻
holding clothes=拿着衣服
smoking=抽烟
purple shirt=紫色衬衫
cannon=大炮
black bodysuit=黑色连体衣
red hairband=红色发带
black sclera=黑色巩膜
chinese text=中文文本
angel=天使
blue kimono=蓝色和服
leg lift=抬腿
bandeau=抹胸
highleg panties=高筒裤
gothic lolita=哥特洛丽塔
red cape=红斗篷
ass focus=屁股焦点
goatee=山羊胡子
pink bikini=粉色比基尼
beanie=帽子
name tag=名称标签
wince=畏缩
hand on own cheek=手放在自己的脸颊上
wolf girl=狼女
floral background=花卉背景
off-shoulder shirt=露肩衬衫
bun cover=好封面
unbuttoned=解开扣子
clock=钟
hat flower=帽子花
jack-o'-lantern=南瓜灯
partially visible vulva=部分可见的外阴
lactation=哺乳期
hand on headwear=手放在头饰上
large areolae=大乳晕
black sleeves=黑色袖子
underbust=下胸围
hitodama=人的灵魂
collared dress=有领连衣裙
blue pants=蓝色裤子
ahegao=A和高
white coat=白大衣
drawstring=拉绳
microskirt=超短裙
swimsuit under clothes=衣服下的泳衣
purple nails=紫色指甲
gift box=礼物盒
criss-cross halter=十字交叉露背
food on face=脸上的食物
bookshelf=书架
gangbang=钢棒
tabi=或者
back-to-back=背靠背
eyeball=眼球
basket=篮子
character doll=人物娃娃
petticoat=衬裙
logo=标识
untied=解开
nipple slip=乳头滑落
bandaid on face=创可贴在脸上
tail ornament=尾饰
suspender skirt=吊带裙
gakuran=校服
large penis=大阴茎
blue gloves=蓝色手套
grabbing from behind=从后面抓住
cabbie hat=司机帽
blue bowtie=蓝色领结
hand on another's shoulder=把手放在另一个人的肩膀上
saliva trail=唾液痕迹
fairy wings=仙女的翅膀
pocky=百奇
white scarf=白围巾
argyle=亚皆老街
size difference=尺寸差异
covered mouth=捂嘴
armored dress=铠甲裙
lace-up boots=系带靴
yellow ascot=黄领巾
red vest=红色背心
toenail polish=脚趾甲油
pointless censoring=毫无意义的审查
taut clothes=绷紧的衣服
shrug (clothing)=耸肩（衣服）
holding flower=拿着花
onsen=温泉
guitar=吉他
silhouette=轮廓
leaning back=向后靠
silent comic=无声漫画
vambraces=护臂
kneepits=膝盖骨
tiles=瓷砖
headdress=头饰
unzipped=解压缩
2koma=2回
center frills=中心装饰
butterfly hair ornament=蝴蝶发饰
winter clothes=冬天的衣服
gohei=五平
military vehicle=军车
drinking=喝
black cape=黑斗篷
crotch seam=裆缝
on head=在头上
vision (genshin impact)=愿景（原神影响）
cow print=牛印
red lips=红唇
cow ears=牛耳朵
highleg swimsuit=高腿泳衣
brown thighhighs=棕色长筒袜
heart censor=心脏审查员
witch=巫婆
retro artstyle=复古艺术风格
no nose=没鼻子
pen=笔
female child=女童
electricity=电
spaghetti strap=细肩带
arm grab=手臂抓
anchor=锚
everyone=每个人
shirt tucked in=衬衫塞进去
pool=水池
sundress=太阳裙
glass=玻璃
bridal garter=新娘吊袜带
checkered clothes=格子衣服
naval uniform=海军制服
wind lift=风举
korean text=韩语文本
adjusting eyewear=调整眼镜
selfie=自拍
poke ball (basic)=精灵球（基本）
bangle=手镯
bound wrists=绑手腕
flag=旗帜
cleft of venus=金星裂
facing away=背对着
mittens=连指手套
frog=青蛙
double-breasted=双排扣
headpat=拍头
wedding ring=结婚戒指
reading=阅读
classroom=课堂
blue thighhighs=蓝色长筒袜
chromatic aberration=色差
purple bikini=紫色比基尼
salute=礼炮
flipped hair=翻转的头发
smug=踌躇满志
notice lines=注意线
pinafore dress=围裙连衣裙
fur-trimmed jacket=毛皮边饰夹克
scythe=镰
ankle boots=踝靴
cheerleader=啦啦队长
chestnut mouth=栗子嘴
absurdly long hair=荒谬的长头发
magic=魔法
nun=绝不
muneate=木乃伊
car=车
talking=说
holding knife=拿着刀
hair stick=发棒
wristwatch=手表
waitress=服务员
food-themed hair ornament=以食物为主题的发饰
airplane=飞机
stud earrings=耳钉
strap gap=表带间隙
light blue hair=淡蓝色的头发
inverted nipples=内陷的乳头
potted plant=盆栽
pulled by self=自己拉的
pom pom (cheerleading)=pom pom（啦啦队）
beachball=沙滩球
light=光
uneven legwear=不均匀的裤袜
foot focus=足部焦点
hand to own mouth=手到自己的嘴
sideways glance=侧身一瞥
gagged=堵嘴
flat cap=平盖
nurse=护士
brown belt=棕带
animal costume=动物服装
bikini under clothes=衣服下的比基尼
road=路
earmuffs=耳套
spoken question mark=口语问号
holding poke ball=拿着精灵球
bare back=裸背
nipple tweak=乳头调整
bukkake=颜射
hands on own chest=双手放在自己的胸前
horn ornament=喇叭饰品
bucket=桶
kita high school uniform=北高中制服
hair behind ear=耳朵后面的头发
ninja=忍者
style parody=风格模仿
assault rifle=突击步枪
back bow=背弓
armored boots=装甲靴
fishnet pantyhose=渔网连裤袜
rigging=索具
lamp=灯
hair over eyes=眼睛上的头发
eyeliner=眼线笔
tatami=榻榻米
bags under eyes=眼袋
cow horns=牛角
battle=战斗
femdom=调教
white sweater=白毛衣
candle=蜡烛
controller=控制器
bench=长椅
bush=衬套
scales=秤
happy sex=快乐的性爱
sailor shirt=水手衫
mask on head=头上的面具
overalls=工作服
steaming body=热气腾腾的身体
hakama short skirt=裤裙短裙
triangular headpiece=三角头饰
sexually suggestive=性暗示
cityscape=城市景观
snake hair ornament=蛇发饰
mecha musume=非常女儿
biting=咬
tube top=抹胸
crown braid=皇冠辫子
toeless legwear=露趾裤
naked shirt=裸衫
riding=骑术
brown dress=棕色连衣裙
pov hands=pov 手
:>=:>
bow bra=蝴蝶结文胸
>:)=>:)
mini crown=迷你皇冠
pink headwear=粉色头饰
bird wings=鸟的翅膀
stuffed bunny=毛绒兔子
bad anatomy=解剖学不好
bodystocking=连体袜
bridal veil=婚礼面纱
reaching towards viewer=伸向观众
japanese armor=日本盔甲
joints=关节
fairy=仙女
+++=+++
halloween costume=万圣节服装
blue leotard=蓝色紧身衣
pilot suit=飞行员服
cable=电缆
fake horns=假角
open fly=开飞
red kimono=红色和服
purple panties=紫色内裤
pleated dress=百褶连衣裙
creature=生物
orgasm=性高潮
dark=黑暗的
ice wings=冰翼
covering crotch=遮裆
shade=阴影
wet shirt=湿衬衫
space=空间
claw pose=爪式
sarong=围裙
red hakama=红色也是
triangle mouth=三角口
hugging own legs=抱自己的腿
print kimono=印花和服
breast pocket=胸袋
bracer=支撑
bathing=沐浴
key=钥匙
black collar=黑领
5boys=5个男孩
school desk=课桌
red panties=红色内裤
single side bun=单面包子
randoseru=书包
red choker=红色项圈
peach=桃
holster=皮套
air bubble=气泡
food in mouth=嘴里的食物
alternate eye color=交替的眼睛颜色
heart hands=心手
sack=解雇
indian style=印度风格
lolita hairband=洛丽塔发带
oil-paper umbrella=油纸伞
white outline=白色轮廓
confetti=五彩纸屑
dagger=匕首
heart of string=弦之心
against wall=靠墙
frilled shirt=荷叶边衬衫
painting (medium)=绘画（中）
own hands clasped=自己双手紧握
print legwear=印花裤袜
hands on own face=双手放在自己的脸上
yellow bikini=黄色比基尼
low wings=低翼
laughing=笑
holding bag=拿着袋子
snowflakes=雪花
paw print=掌印
cross-laced clothes=交叉花边的衣服
wet hair=湿的头发
one breast out=一个乳房
pink jacket=粉色夹克
autumn leaves=秋天的树叶
blue rose=蓝玫瑰
petite=小的
antlers=鹿角
star-shaped pupils=星形瞳孔
hair up=头发起来
holding bottle=拿着瓶子
lace-trimmed legwear=蕾丝边饰裤袜
polka dot background=圆点背景
cone hair bun=锥形发髻
drunk=醉
alternate hair color=交替发色
hibiscus=木槿
feather hair ornament=羽毛发饰
carrot=胡萝卜
whisker markings=晶须标记
paw gloves=爪子手套
string=细绳
yellow jacket=黄夹克
incest=乱伦
furry male=毛茸茸的男性
cum in ass=暨在屁股
plugsuit=插头套装
bath=洗澡
stretching=伸展
office lady=办公室女职员
raccoon ears=浣熊耳朵
arm tattoo=手臂纹身
pumpkin=南瓜
star print=星印
wrist scrunchie=手腕发圈
zipper pull tab=拉链拉环
anal object insertion=肛门物体插入
tate eboshi=垂直的 eboshi
red thighhighs=红色长筒袜
hand on another's face=把手放在另一个人的脸上
wine glass=红酒杯
brown shirt=棕色衬衫
black sweater=黑色毛衣
habit=习惯
facepaint=面漆
marker (medium)=标记（中）
bat (animal)=蝙蝠（动物）
holding fan=拿着扇子
scabbard=刀鞘
crescent hair ornament=新月发饰
ribbon choker=丝带项圈
computer=电脑
parasol=阳伞
thighlet=小腿
blood on clothes=衣服上的血
navel cutout=肚脐镂空
purple gloves=紫色手套
torii=牌坊
sakuragaoka high school uniform=樱丘高中制服
haori=羽织
asymmetrical wings=不对称的翅膀
teapot=茶壶
tasuki=田月
holding tray=托盘
grey dress=灰色连衣裙
tiger ears=虎耳
axe=斧头
string panties=细绳内裤
watercraft=船只
artist logo=艺术家标志
tight=紧的
cum on clothes=射在衣服上
purple jacket=紫色夹克
belly=腹部
nipple piercing=乳头穿孔
shibari=捆绑
happy new year=新年快乐
mismatched legwear=不匹配的裤袜
chinese zodiac=中国十二生肖
magatama=勾玉
slippers=拖鞋
male child=男童
black border=黑边
lace-trimmed panties=蕾丝边内裤
black kimono=背和服
precum=作为
pink kimono=粉色和服
transparent=透明的
bald=秃
wagashi=和果子
hip vent=臀部发泄
tachi-e=画质
fang out=发狂
vampire=吸血鬼
yellow neckerchief=黄色围巾
bikini skirt=比基尼裙
open cardigan=开衫
highleg bikini=比基尼亮点
red shorts=红色短裤
hand on own head=手放在自己的头上
purple headwear=紫色头饰
after vaginal=阴道后
tied shirt=绑衬衫
garrison cap=驻军帽
curled horns=卷曲的角
sample watermark=样本水印
arm strap=臂带
knee pads=护膝
midriff peek=腹部偷看
condom wrapper=避孕套包装纸
grabbing own breast=抓住自己的乳房
torn pantyhose=撕裂的连裤袜
one-piece tan=连体棕褐色
mouse tail=老鼠尾巴
hand on own chin=手托着自己的下巴
layered sleeves=分层袖子
giant=巨大的
evil smile=邪恶的微笑
nosebleed=鼻血
crescent hat ornament=新月帽饰
dancing=跳舞
tiger print=虎纹
leg ribbon=腿带
looking afar=远眺
half gloves=半手套
presenting=呈现
green skin=绿色皮肤
princess carry=公主背
layered dress=层叠连衣裙
purple thighhighs=紫色长筒袜
blue vest=蓝背心
pantyhose pull=连裤袜拉
raglan sleeves=插肩袖
magic circle=魔法阵
short kimono=短和服
very short hair=很短的头发
shoulder blades=肩胛
asymmetrical clothes=衣服不对称
blue bra=蓝色文胸
striped background=条纹背景
green bikini=绿色比基尼
shoulder cutout=肩部镂空
scared=害怕的
balloon=气球
legwear under shorts=短裤下的紧身裤
deep skin=深层皮肤
aura=光环
wall=墙
layered skirt=层叠裙
draph=草稿
used condom=用过的避孕套
hair censor=头发审查员
body fur=体毛
over shoulder=过肩
head wreath=头花环
tail raised=尾巴抬起
kicking=踢
mother and daughter=母亲和女儿
open hand=张开手
sound effects=声音特效
reference sheet=参考表
tracen school uniform=追踪校服
mechanical arms=机械臂
one knee=一个膝盖
w=在
yellow dress=黄色连衣裙
manly=有男子气概的
male underwear=男性内衣
huge ass=巨大的屁股
graphite (medium)=石墨（中）
tea=茶
backless dress=露背连衣裙
grey pants=灰色裤子
public indecency=公开猥亵
hat feather=帽子羽毛
crop top overhang=作物顶部悬垂
open kimono=打开和服
pigeon-toed=内八字
paintbrush=画笔
red ascot=红领巾
holding polearm=抱杆臂
leather=皮革
lace-trimmed bra=蕾丝边饰文胸
disposable cup=一次性杯子
futa with female=futa 与 女性
torpedo=鱼雷
o-ring top=O型环顶部
naked towel=裸毛巾
star earrings=星星耳环
ringed eyes=眼圈
mermaid=美人鱼
limited palette=有限的调色板
o-ring bikini=奥林比基尼
on couch=在沙发上
holding microphone=拿着话筒
shimenawa=下轮
animification=动画化
animal on head=头上的动物
mmf threesome=男朋友三人行
bandaged leg=绷带腿
squiggle=波浪线
in container=在容器中
photo (object)=照片（物体）
blue neckerchief=蓝色围巾
glowing eye=发光的眼睛
field=场地
maple leaf=枫叶
yellow skirt=黄色裙子
greaves=油渣
gap (touhou)=gap (投后)
architecture=建筑学
bedroom=卧室
breast sucking=吸乳
sleeveless turtleneck=无袖高领衫
watercolor (medium)=水彩（中）
bare pectorals=裸胸
company name=公司名称
symmetrical docking=对称对接
leg grab=抢腿
red leotard=红色紧身衣
gameplay mechanics=游戏机制
bound arms=束手无策
out-of-frame censoring=帧外审查
ooarai school uniform=大洗校服
sunbeam=阳光
lineart=线条艺术
imminent penetration=迫在眉睫的渗透
brown pants=棕色裤子
bamboo=竹子
imminent kiss=迫在眉睫的吻
thumbs up=竖起大拇指
multiple persona=多重角色
clothes around waist=腰间的衣服
green nails=绿色指甲
tile floor=瓷砖地板
shoulder tattoo=肩部纹身
undercut=底切
polka dot bow=圆点蝴蝶结
halftone=半色调
peeing=撒尿
arm cannon=臂炮
blue hairband=蓝色发带
sleeve cuffs=袖口
under covers=卧底
explosion=爆炸
cowbell=牛铃
white cape=白斗篷
holding hair=拿着头发
naked apron=裸体围裙
cross necklace=十字架项链
singing=唱歌
pee=撒尿
print shirt=印花衬衫
leggings=绑腿
shackles=镣铐
pencil=铅笔
checkered floor=方格地板
stitches=针脚
black hoodie=黑色连帽衫
slingshot swimsuit=弹弓泳衣
pubic tattoo=阴部纹身
double penetration=双渗透
foot out of frame=脚在框架外
idol=偶像
bra lift=好电梯
ruins=废墟
summer=夏天
vines=藤蔓
falling=坠落
raccoon tail=浣熊尾巴
striped dress=条纹连衣裙
black cat=黑猫
strap=带子
torn thighhighs=大腿撕裂
white capelet=白色披肩
hair over breasts=乳房上的头发
purple footwear=紫色鞋类
^o^=^o^
head fins=头鳍
arm under breasts=手臂在乳房下
annoyed=生气
mushroom=蘑菇
house=房子
iron cross=铁十字
black scarf=黑色围巾
tilted headwear=倾斜的头饰
two-tone dress=双色连衣裙
spoken exclamation mark=口语感叹号
skirt pull=裙子拉
plaid vest=格子背心
3koma=不育症
eyewear removed=摘下眼镜
name connection=名称连接
tank=坦克
vaginal object insertion=阴道物体插入
dark persona=黑暗的人
fox mask=狐狸面具
artist self-insert=艺术家自我插入
spiked bracelet=尖刺手链
scar on cheek=脸颊上的伤疤
platform footwear=厚底鞋
id card=身份证
genderswap (ftm)=性别互换 (ftm)
erune=得到它
tinted eyewear=有色眼镜
face-to-face=面对面
bathroom=浴室
sad=伤心
french kiss=法式接吻
television=电视
asymmetrical docking=不对称对接
one-eyed=独眼
ranguage=范围
duel monster=决斗怪物
invisible chair=看不见的椅子
huge weapon=巨大的武器
long sideburns=长鬓角
pants pull=裤子拉
trigger discipline=触发纪律
head scarf=头巾
hand on own thigh=手放在自己的大腿上
bikini pull=比基尼拉
hachimaki=八卷
doughnut=油炸圈饼
partially unbuttoned=部分解开
hand on own knee=手放在自己的膝盖上
official alternate hairstyle=官方备用发型
tiptoes=踮起脚尖
red horns=红角
grey footwear=灰色鞋类
babydoll=婴儿娃娃
white choker=白色项圈
bikini armor=比基尼盔甲
shoulder pads=垫肩
sakazuki=坂月
holding animal=控股动物
headphones around neck=脖子上的耳机
cutoffs=截止点
yukkuri shiteitte ne=慢慢说
white eyes=白色的眼睛
animal focus=动物焦点
black neckerchief=黑色围巾
fur-trimmed sleeves=毛皮边袖
white fur=白色皮毛
wide shot=广角镜头
x-ray=X光
sandwiched=夹在中间
white rose=白玫瑰
bread=面包
necktie between breasts=乳房之间的领带
m legs=米腿
cunnilingus=舔阴
camouflage=伪装
narrow waist=柳腰
disembodied limb=无形的肢体
old=老的
grey skin=灰色皮肤
fundoshi=缠腰带
shorts under skirt=裙子下的短裤
starry background=星空背景
0 0=0 0
purple kimono=紫色和服
oversized clothes=超大衣服
crescent moon=新月
holding another's wrist=握着别人的手腕
summer uniform=夏季制服
orange skirt=橙色裙子
sweater dress=毛衣连衣裙
holding gift=拿着礼物
constricted pupils=收缩的瞳孔
split=分裂
striped necktie=条纹领带
dripping=滴水
on ground=在地上
covered eyes=遮住眼睛
navel piercing=肚脐穿孔
sliding doors=滑动门
leaf hair ornament=叶子发饰
big hair=大头发
earphones=耳机
futon=蒲团
winter=冬天
interspecies=种间
star hat ornament=星帽饰品
cross-section=横截面
body writing=正文
voice actor connection=声优连接
ffm threesome=三人组
symbol in eye=眼睛里的符号
two tails=两条尾巴
aqua nails=水指甲
splashing=飞溅
cow girl=牛姑娘
armpit crease=腋下皱纹
brick wall=砖墙
neck ring=颈环
wardrobe malfunction=衣柜故障
leaf on head=头上的叶子
bonnet=引擎盖
rolling eyes=翻白眼
standing sex=站着做爱
multiple others=多人
bishounen=英俊男孩
checkered background=方格背景
facial tattoo=面部纹身
arm garter=手臂吊袜带
no pupils=没有学生
smoking pipe=烟斗
handcuffs=手铐
frilled bow=褶边蝴蝶结
holding fruit=拿着水果
;o=;哦
bobby socks=鲍比袜子
casual one-piece swimsuit=休闲连体泳衣
pink theme=粉色主题
orange shirt=橙色衬衫
broom riding=骑扫帚
untied bikini=解开比基尼
foreskin=包皮
anchor hair ornament=船锚发饰
breast rest=乳房休息
frilled panties=褶边内裤
pink rose=粉红玫瑰
cookie=曲奇饼
yellow necktie=黄色领带
shoes removed=脱鞋
soaking feet=泡脚
spiked collar=尖领
straight-on=直截了当
handheld game console=掌上游戏机
water bottle=水瓶
arm ribbon=臂带
christmas tree=圣诞树
yin yang=阴阳
tiger tail=虎尾巴
folded=折叠
fireworks=烟花
afterimage=残像
gyaru=提升
forehead jewel=额头上的宝石
blue scarf=蓝色围巾
toned male=健美的男性
object on head=头上的物体
partially colored=部分着色
arm guards=护臂
fish tail=鱼尾
chalkboard=黑板
sheet grab=床单抓取
short over long sleeves=长袖短袖
mitakihara school uniform=三泷原校服
rimless eyewear=无框眼镜
anniversary=周年纪念日
!!=!!
purple theme=紫色主题
syringe=注射器
asymmetrical gloves=不对称手套
single shoe=单鞋
1990s (style)=1990 年代（风格）
watermelon=西瓜
bridge=桥
sitting on lap=坐在膝上
fat=胖的
stool=凳子
rice=米
badge=徽章
print bikini=印花比基尼
monitor=监视器
goat horns=山羊角
purple skin=紫色皮肤
east asian architecture=东亚建筑
:/=:/
vehicle focus=车辆焦点
implied sex=隐含的性
submachine gun=冲锋枪
green panties=绿色内裤
lion ears=狮子耳朵
shoe soles=鞋底
sailor senshi uniform=水手战士制服
green vest=绿色背心
playing instrument=演奏乐器
heart brooch=心形胸针
fur-trimmed coat=毛皮边饰大衣
red skin=红皮肤
heart earrings=心形耳环
engrish text=英文文本
multicolored background=多彩多姿的背景
red pants=红裤子
micro shorts=超短裤
hammer=锤子
fur-trimmed gloves=毛边手套
red theme=红色主题
brown sweater=棕色毛衣
torn shirt=破衬衫
ripples=涟漪
chibi inset=赤壁插图
dappled sunlight=斑驳的阳光
brown coat=棕色外套
red capelet=红披肩
pointing at viewer=指着观众
licking penis=舔阴茎
hooded cloak=连帽斗篷
beer=啤酒
scroll=滚动
content rating=内容评级
brothers=兄弟
sake=清酒
rainbow=彩虹
jaggy lines=锯齿状线条
fringe trim=流苏装饰
egg=蛋
skirt removed=裙子被移除
giantess=病娇
erection under clothes=在衣服下勃起
blue choker=蓝色项圈
white bodysuit=白色连体衣
fucked silly=操傻
sniper rifle=狙击枪
official style=官风
white tank top=白色背心
planet=行星
holding instrument=拿着仪器
mini top hat=迷你上衣很火
tying hair=扎头发
grey shorts=灰色短裤
pink thighhighs=粉色长筒袜
rabbit hair ornament=兔子发饰
undershirt=汗衫
d:=d:
skin-covered horns=皮肤覆盖的角
bathtub=浴缸
karakasa obake=伞鬼
frilled bra=褶边很好
feeding=喂养
ears through headwear=耳朵穿过头饰
on chair=在椅子上
off-shoulder sweater=露肩毛衣
belt pouch=腰包
miqo'te=延伸出
holding stuffed toy=拿着毛绒玩具
lowleg panties=低腿内裤
motorcycle=摩托车
print panties=印花内裤
jiangshi=僵尸
error=错误
cushion=软垫
bikini bottom only=仅比基尼泳裤
fishnet thighhighs=网眼长筒袜
holding plate=托板
cherry=樱桃
sepia=棕褐色
yellow bowtie=黄色领结
torogao=公牛脸
police=警察
downblouse=下胸罩
cyborg=电子人
chess piece=棋子
zzz=zzz
power lines=电力线路
coin=硬币
black capelet=黑色披肩
latex=乳胶
3:=3:
ribs=肋骨
game controller=游戏控制器
race queen=赛车皇后
lamppost=灯柱
merry christmas=圣诞节快乐
front ponytail=前马尾辫
panties removed=内裤被移除
body blush=身体腮红
reverse cowgirl position=反向女牛仔位置
nervous=紧张的
seductive smile=诱人的微笑
bead bracelet=珠手链
chaldea uniform=迦勒底制服
scissors=剪刀
birthday=生日
white bowtie=白色领结
frilled hairband=褶边发箍
holding bouquet=拿着花束
white belt=白带
sleepy=困
faulds=故障
horse=马
\m/=\米/
hair slicked back=头发向后梳
bear ears=熊耳朵
tail wagging=摇尾巴
perspective=看法
long coat=长大衣
pinky out=伸出小指
green necktie=绿色领带
dirty=肮脏的
bead necklace=珠子项链
leaning to the side=靠在一边
reclining=躺着的
clothed male nude female=男裸女
brown shorts=棕色短裤
otonokizaka school uniform=音木坂校服
saucer=飞碟
shirt pull=衬衫拉
taut shirt=紧身衬衫
sheep horns=羊角
light frown=轻轻皱眉
blank eyes=茫然的眼睛
harness=马具
white collar=白领
girl sandwich=女孩三明治
uwabaki=拖鞋
chest hair=胸毛
bride=新娘
heads together=齐头并进
shell=壳
shouting=大喊大叫
track suit=田径服
punching=冲孔
blue cape=蓝色斗篷
multi-strapped bikini=多带比基尼
loose socks=宽松的袜子
kariginu=他的帖子
animalization=动物化
blue sweater=蓝色毛衣
trait connection=特质联系
green theme=绿色主题
unfinished=未完成
pun=甚至
broken=破碎的
white hoodie=白色连帽衫
playing card=纸牌
coffee=咖啡
red coat=红外套
plaid shirt=格子衬衫
huge ahoge=巨大的
cum string=暨串
grey sweater=灰色的毛衣
take your pick=随你挑
torso grab=躯干抓
pillow hug=抱枕
green shorts=绿色短裤
grey gloves=灰色手套
male swimwear=男泳装
bruise=挫伤
ball gag=球塞
pointy hair=尖尖的头发
brown cardigan=棕色开衫
pervert=色狼
beamed eighth notes=八分音符
nekomata=猫又
animal hat=动物帽
hair pulled back=头发向后拉
assertive female=自信的女性
pink bowtie=粉色领结
jester cap=小丑帽
bestiality=兽交
skeleton=骨骼
planted=种植
bandaid on leg=腿上的绷带
striped bowtie=条纹领结
oversized object=超大物体
aqua background=浅绿色背景
waist cape=腰披风
green kimono=绿色和服
tentacle sex=触手性
fat mons=脂肪瘤
black tank top=黑色背心
burger=汉堡包
old man=老人
cooking=烹饪
black horns=黑角
fur-trimmed capelet=毛皮边披肩
green footwear=绿色鞋类
xd=xd
no eyes=没有眼睛
lap pillow=抱枕
holding chopsticks=拿着筷子
multicolored dress=五彩裙子
poolside=泳池边
clipboard=剪贴板
purple bowtie=紫色领结
suggestive fluid=暗示性液体
over-kneehighs=过膝
dark background=深色背景
pregnant=孕
spoken musical note=口语音符
doll joints=娃娃关节
beach umbrella=沙滩伞
horn ribbon=喇叭丝带
speed lines=速度线
bra pull=好拉
holding bow (weapon)=拿着弓（武器）
nightgown=睡衣
fur=毛皮
split mouth=裂口
plaid scarf=格子围巾
animal nose=动物鼻子
standing split=站立分裂
grey headwear=灰色头饰
yawning=打哈欠
falling petals=飘落的花瓣
wine=葡萄酒
mouse=老鼠
kotatsu=被炉
twisted torso=扭曲的躯干
cum on ass=暨屁股
mechanical halo=机械光环
onee-shota=onee shota
expressions=表达
pectoral cleavage=胸沟
bubble skirt=泡泡裙
shelf=架子
purple bra=紫色文胸
loincloth=缠腰布
braided bun=辫子发髻
pillar=支柱
female orgasm=女性高潮
see-through sleeves=透视袖
huge penis=巨大的阴茎
tokiwadai school uniform=Tokiwadai 由 Unifor rm 撰写
whip=鞭子
sweating profusely=大汗淋漓
weapon over shoulder=肩上的武器
biceps=二头肌
grey thighhighs=灰色长筒袜
cow tail=牛尾巴
playing games=玩游戏
red sweater=红色毛衣
red collar=红领
gigantic breasts=巨大的乳房
cardboard box=纸板箱
ear blush=耳朵红
skull hair ornament=头骨发饰
multicolored skin=五颜六色的皮肤
pink gloves=粉色手套
bare tree=光秃秃的树
tassel earrings=流苏耳环
paper fan=纸扇
shark tail=鲨鱼尾巴
superhero=超级英雄
street=街道
damaged=损坏的
polka dot panties=圆点内裤
holding spoon=拿着勺子
:|=:|
river=河
female ejaculation=女性射精
flat color=单色
topknot=头饰
aqua necktie=水绿色领带
diamond (shape)=钻石（形状）
animal collar=动物项圈
stand (jojo)=站立（乔乔）
castle=城堡
tape=磁带
time paradox=时间悖论
orb=球体
footjob=脚交
sparkling eyes=明亮的眼睛
=3==3
baseball bat=棒球棒
grapes=葡萄
police uniform=警察制服
laptop=笔记本电脑
between fingers=指间
lily (flower)=百合花）
extra arms=额外的武器
patreon logo=赞助标志
explosive=爆炸性的
wet panties=湿内裤
red bra=红色文胸
extra eyes=额外的眼睛
sweater lift=毛衣提升
female pervert=女变态
fur-trimmed cape=毛皮边斗篷
flag print=旗帜印花
single mechanical arm=单机械臂
single sock=单袜子
book stack=书架
uterus=子宫
thighhighs under boots=靴子下的大腿
blue coat=蓝色外套
argyle legwear=菱格纹裤袜
split-color hair=分色头发
vertical-striped thighhighs=竖条纹长筒袜
pink choker=粉红色项圈
breast envy=乳房羡慕
yellow footwear=黄色鞋类
black blindfold=黑色眼罩
dressing=敷料
unmoving pattern=不动的图案
forehead protector=前额保护器
open vest=开背心
company connection=公司关系
waistcoat=马甲
hand on own stomach=手放在自己的肚子上
super crown=超级皇冠
facing another=面对另一个
gym shirt=运动衫
single bare shoulder=单肩
long braid=长辫子
;p=;p
penguin=企鹅
diagonal stripes=斜条纹
hand on own ass=手放在自己的屁股上
shopping bag=购物包
bokeh=背景虚化
chain-link fence=铁丝网
heart cutout=心形镂空
bursting breasts=爆裂的乳房
electric guitar=电吉他
frilled thighhighs=褶边长筒袜
tengu-geta=插件能力
v-neck=V领
exhibitionism=暴露狂
dog tags=狗牌
fox shadow puppet=狐狸皮影
dango=空间
covering face=遮脸
competition school swimsuit=竞赛学校泳装
albino=白化病
adjusting headwear=调整头饰
charm (object)=魅力（对象）
monocle=单片眼镜
internal cumshot=内部射液
meat=肉
costume switch=服装开关
purple lips=紫色的嘴唇
fur-trimmed dress=毛皮边饰连衣裙
twilight=暮
tail ribbon=尾带
autumn=秋天
colored tips=彩色提示
danmaku=弹幕
zombie=僵尸
yandere=艳德热
moaning=呻吟
clothes removed=脱下衣服
looking ahead=展望未来
breast suppress=乳房抑制
hands on own cheeks=双手放在自己的脸颊上
braided bangs=编织刘海
wolf=狼
shorts pull=短裤拉
sanpaku=三个晚上
tail bow=尾弓
holding eyewear=拿着眼镜
holding hat=拿着帽子
serval print=伺服打印
infection monitor (arknights)=感染监测器（明日方舟）
no socks=没有袜子
blood splatter=血溅
traditional bowtie=传统领结
flame=火焰
reaching=达到
water gun=水枪
dougi=同义词
stomach bulge=胃胀
trading card=贸易卡
thong bikini=丁字裤比基尼
quiver=颤动
holding card=持卡
teardrop=泪珠
floating object=漂浮物
gold=金子
holding fork=拿着叉子
anal beads=肛珠
armpit peek=腋下偷看
military jacket=军装夹克
ship=船
knight=骑士
cum on tongue=暨在舌头上
onigiri=饭团
thigh holster=大腿皮套
firing=射击
heart print=心印
prosthesis=假肢
microphone stand=话筒架
pink sweater=粉色毛衣
closed umbrella=闭合的伞
mind control=精神控制
cross earrings=交叉耳环
flower field=花田
fake screenshot=假截图
father and daughter=父亲和女儿
leg warmers=暖腿套
cowboy hat=牛仔帽
green gloves=绿色手套
noodles=面条
jumpsuit=连衣裤
solid circle eyes=实心圆形眼睛
family=家庭
fox=狐狸
hydrangea=绣球花
train interior=火车内部
paper lantern=纸灯笼
robot joints=机器人关节
chest jewel=胸部珠宝
glaring=刺眼的
weapon on back=背上的武器
ear covers=耳套
leotard under clothes=衣服下面的紧身连衣裤
rose petals=玫瑰花瓣
convenient leg=方便的腿
sleeveless jacket=无袖外套
turn pale=脸色苍白
skyscraper=摩天大楼
dimples of venus=金星的酒窝
heart ahoge=心脏
breast lift=隆胸
chest tattoo=胸部纹身
bicycle=自行车
pov crotch=pov 胯部
yellow hairband=黄色发带
holding wand=拿着魔杖
side-by-side=并排
vase=花瓶
halter dress=吊带裙
oripathy lesion (arknights)=矿石病病变（明日方舟）
unsheathing=出鞘
lance=槊
amputee=截肢者
yellow nails=黄色指甲
roswaal mansion maid uniform=罗兹瓦尔宅邸女仆服
peeking out=偷看
disembodied penis=无实体的阴茎
red bodysuit=红色紧身连衣裤
pink hairband=粉色发带
picture frame=镜框
colored pencil (medium)=彩色铅笔（中号）
old school swimsuit=老学校泳装
bone=骨
full armor=全副武装
chick=小鸡
red wings=红色的翅膀
striped ribbon=条纹丝带
no mouth=没有嘴
plaid bow=格子蝴蝶结
single wing=单翼
condom in mouth=嘴里的避孕套
yellow sclera=黄色巩膜
large bow=大弓
double handjob=双打手枪
purple leotard=紫色紧身衣
frilled choker=褶边扼流圈
brown bow=棕色蝴蝶结
kitsune=狐狸
knees=膝盖
blue hoodie=蓝色连帽衫
hooded coat=连帽大衣
knees to chest=膝盖到胸部
long bangs=长刘海
solid oval eyes=坚实的椭圆形眼睛
waves=波浪
side braids=侧辫子
strap pull=拉带
multiple 4koma=多个 4koma
elbow pads=护肘
pussy peek=猫偷看
beer mug=啤酒杯
dark blue hair=深蓝色的头发
naked ribbon=裸丝带
short necktie=短领带
open hoodie=开帽衫
heart-shaped box=心形的盒子
holding ball=拿着球
mixed bathing=混浴
detached wings=分离的翅膀
grabbing another's hair=抓别人的头发
bow hairband=蝴蝶结发带
holding can=拿着可以
ladle=钢包
utility pole=电线杆
navel hair=肚脐毛
fur hat=因为有
panty peek=偷看内裤
spring onion=葱
revolver=左轮手枪
striped scarf=条纹围巾
shushing=嘘声
one-piece swimsuit pull=连体泳衣拉
trident=三叉戟
brown vest=棕色背心
popped collar=立领
bra strap=好表带
blunt ends=钝头
whistle=哨
notebook=笔记本
arthropod girl=节肢动物女孩
striped skirt=条纹裙
projectile cum=射弹与
aiguillette=针
gourd=葫芦
reverse trap=反向陷阱
white necktie=白色领带
faceless female=无脸女
heart pasties=心馅饼
pillow hat=枕头帽
ringlets=小环
money=钱
impossible shirt=不可能的衬衫
bandaid on nose=鼻子上的创可贴
flight deck=飞行甲板
pinstripe pattern=细条纹图案
fedora=软呢帽
holding strap=固定带
grabbing own ass=抓自己的屁股
heart-shaped chocolate=心形巧克力
lowleg bikini=低腿比基尼
crazy eyes=疯狂的眼睛
single elbow glove=单肘手套
cropped shirt=短款衬衫
maebari=前衬
evening=晚上
>:(=>:(
hands on own knees=双手放在自己的膝盖上
garreg mach monastery uniform=石马修道院制服
gears=齿轮
waking up=起来
winter coat=冬衣
lock=锁
showgirl skirt=歌舞女郎裙
squatting cowgirl position=蹲女牛仔姿势
cable knit=绞花针织
reverse grip=反握
orange bikini=橙色比基尼
slime (substance)=粘液（物质）
cane=甘蔗
asymmetrical sleeves=不对称袖子
throne=王座
ice cream cone=蛋卷冰淇淋
green pants=绿色裤子
white neckerchief=白围巾
business suit=商务套装
blood on hands=手上有血
flower knot=花结
lightning=闪电
vertical-striped shirt=竖条纹衬衫
sailor=水手
blue fire=蓝色火焰
tower=塔
poster (object)=海报（对象）
white bloomers=白色灯笼裤
tile wall=瓷砖墙
orange (fruit)=橘子（水果）
tomboy=假小子
print skirt=印花裙
machine gun=机枪
crotchless=开裆
skinny=瘦骨嶙峋的
bound legs=绑腿
thigh grab=大腿抓
unbuttoned shirt=解开的衬衫
wedgie=婚纱
waterfall=瀑布
statue=雕像
poking=戳
pearl necklace=珍珠项链
leg tattoo=腿部纹身
butterfly wings=蝴蝶翅膀
crack=裂缝
two-sided fabric=双面布
blue bodysuit=蓝色连体衣
bustier=紧身胸衣
boy on top=男孩在上面
multicolored jacket=五彩夹克
polka dot bikini=圆点比基尼
baby=婴儿
crowd=人群
bra visible through clothes=透过衣服可以看到文胸
streaming tears=流泪
dark elf=黑暗精灵
wrist ribbon=腕带
red buruma=红色灯笼裤
toeless footwear=露趾鞋
snowman=雪人
medium skirt=中裙
red scrunchie=红色发带
pink necktie=粉色领带
torn dress=破衣服
pocket watch=怀表
animal on shoulder=肩上的动物
whiskers=胡须
bullet=子弹
towel on head=头巾
open hands=张开双手
yellow shorts=黄色短裤
trench coat=风衣
energy=活力
crotch=裆
bodypaint=人体彩绘
surgical mask=手术口罩
very dark skin=皮肤很黑
boat=船
frilled collar=褶边领
spread anus=张开肛门
toilet=洗手间
kitchen=厨房
letter=信
crab=螃蟹
hand on another's cheek=把手放在另一个人的脸颊上
wine bottle=酒瓶
drawing=绘画
locker=储物柜
purple necktie=紫色领带
dress pull=礼服拉
no pussy=没有猫
bear=熊
yellow theme=黄色主题
defeat=打败
jacket removed=夹克被移除
yellow headwear=黄色头饰
red eyeshadow=红色眼影
fat man=胖子
monster boy=怪物男孩
orange dress=橙色连衣裙
imagining=想像
hot=热的
sagging breasts=下垂的乳房
locked arms=锁定武器
yellow gloves=黄色手套
grey pantyhose=灰色连裤袜
torn pants=破裤子
ribbon-trimmed legwear=缎带边饰裤袜
gradient eyes=渐变眼睛
bird tail=鸟尾巴
bikini bottom aside=比基尼泳裤放在一边
towel around neck=脖子上的毛巾
green bowtie=绿色领结
long tongue=长舌头
soccer uniform=足球服
floppy ears=松软的耳朵
recording=记录
cat hair ornament=猫发饰
imminent rape=迫在眉睫的强奸
evil grin=邪恶的笑容
ear bow=耳弓
fusion=融合
pirate hat=海盗帽
landscape=景观
orange bowtie=橙色领结
on desk=在办公桌上
tsundere=傲娇
blue butterfly=蓝蝴蝶
milk=牛奶
ryouou school uniform=ryou校服
ear ornament=耳饰
assisted exposure=辅助曝光
crescent pin=月牙针
argyle background=菱形背景
crow=乌鸦
road sign=路标
frilled pillow=褶边枕头
cat cutout=猫剪影
anal tail=肛尾
death=死亡
hand on another's chin=把手放在别人的下巴上
unsheathed=出鞘
tiger=老虎
nintendo switch=任天堂开关
mask removed=面具被移除
checkered skirt=格子裙
sideways mouth=侧嘴
hatching (texture)=孵化（纹理）
muted color=柔和的颜色
1koma=1个逗号
interface headset=接口耳机
track pants=运动裤
coffee mug=咖啡杯
black suit=黑色套装
back cutout=背部镂空
yellow panties=黄色内裤
library=图书馆
raised eyebrow=扬起眉毛
torn skirt=撕裂的裙子
bat print=蝙蝠印
holding candy=拿着糖果
starfish=海星
romaji text=Roma即text
alien=外星人
cat lingerie=猫内衣
holding cigarette=拿着香烟
two-tone skin=双色调皮肤
taking picture=拍照
album cover=专辑封面
defloration=摘花
kiseru=穿
teacher=老师
virgin killer sweater=处女杀手毛衣
planted sword=植剑
soap bubbles=肥皂泡
feet up=抬脚
holding paper=拿着纸
school chair=学校椅子
blood on weapon=武器上的血
heart background=心形背景
mountainous horizon=多山的地平线
you gonna get raped=你会被强奸
pink skin=粉红色的皮肤
armchair=扶手椅
school=学校
shy=害羞的
bikini tan=比基尼吨
holding shield=拿着盾牌
blue wings=蓝色的翅膀
snout=鼻子
blue buruma=蓝布鲁玛
sleeves pushed up=袖子挽起来
stick=戳
backboob=后臂
obijime=带御
multicolored nails=多彩多姿的指甲
spoken blush=口语脸红
white camisole=白色吊带背心
costume=戏服
print bow=打印弓
1980s (style)=80 年代（风格）
suitcase=手提箱
halftone background=半色调背景
holding pen=握笔
orange jacket=橙色夹克
mechanical wings=机械翅膀
shark girl=鲨鱼女孩
mandarin orange=橘子
uchiwa=宇智波
soul gem=灵魂宝石
white ascot=白色阿斯科特
husband and wife=丈夫和妻子
cum pool=暨池
no legwear=没有裤袜
lanyard=挂绳
male masturbation=男性自慰
blue sleeves=蓝色袖子
carrot hair ornament=胡萝卜发饰
unaligned breasts=未对齐的乳房
bubble blowing=吹泡泡
dragon wings=龙翼
half-closed eye=半闭眼
command spell=命令法术
clover=三叶草
tissue box=纸巾盒
pouring=浇注
colorful=丰富多彩的
demon=恶魔
dolphin shorts=海豚短裤
striped pantyhose=条纹连裤袜
musical note hair ornament=音符发饰
pointing up=朝上
silk=丝绸
black cloak=黑斗篷
employee uniform=员工制服
falling leaves=落叶
fur-trimmed boots=毛皮边饰靴子
game console=游戏机
belt collar=腰带领
barcode=条码
v over eye=v 在眼睛上
blood from mouth=嘴里流血
lifebuoy=救生圈
multicolored skirt=五彩裙子
the pose=姿势
frilled hat=褶边帽
power armor=动力装甲
:>==:>=
heart necklace=心形项链
bandaid on knee=膝盖上的绷带
grey cardigan=灰色开衫
clone=克隆
button gap=纽扣间隙
leather jacket=皮夹克
black skin=黑皮肤
against glass=对着玻璃
food focus=食物焦点
2021=2021
brown scarf=棕色围巾
jar=罐
paizuri under clothes=paizuri 下 衣服
blue socks=蓝袜子
cross-shaped pupils=十字形瞳孔
ambiguous gender=性别不明
red rope=红绳
pointing at self=指着自己
lamia=拉米亚
cat hood=猫罩
baggy pants=宽松的裤子
fisheye=鱼眼
lake=湖
fur-trimmed headwear=毛皮边饰头饰
waist bow=腰弓
underboob cutout=胸下镂空
purple hairband=紫色发带
puddle=水坑
aiming=瞄准
thong leotard=紧身丁字裤
holding own arm=抱着自己的胳膊
see-through silhouette=透视轮廓
film grain=胶片颗粒
swimming=游泳
photo background=照片背景
dark nipples=深色乳头
smokestack=烟囱
orange headwear=橙色头饰
hands in hair=双手插在头发里
flexible=灵活的
metal collar=金属项圈
earth (planet)=地球（行星）
shop=店铺
backwards hat=向后的帽子
2others=2其他
red moon=红月亮
thorns=荆棘
flaccid=松弛
zouri=看望我
no nipples=没有乳头
aqua bow=水弓
sode=在花园里
mother and son=妈妈和儿子
sleeveless kimono=无袖和服
cheek-to-cheek=脸贴脸
two-tone shirt=双色衬衫
american flag legwear=美国国旗裤袜
mini wings=迷你翅膀
arm hug=手臂拥抱
shrine=神社
leaning=倾斜
framed=陷害
demon slayer uniform=恶魔杀手制服
novelty censor=新奇审查员
yellow sweater=黄色毛衣
spread ass=传播屁股
brown fur=棕色皮毛
pentagram=五角星
2022=2022
imminent vaginal=迫在眉睫的阴道
pince-nez=尖嘴钳
spider lily=蜘蛛百合
v-fin=尾鳍
spider web=蜘蛛网
holding broom=拿着扫帚
nude cover=裸体封面
robot ears=机器耳朵
strapless bikini=露肩比基尼
shide=使得
pink scarf=粉色围巾
painting (object)=绘画（对象）
showering=淋浴
netorare=乌龟
bikini lift=比基尼提升
hose=软管
octopus=章鱼
horror (theme)=恐怖（主题）
red sailor collar=红色水手领
black flower=黑花
nanamori school uniform=七森校服
pole=没有
banana=香蕉
toe scrunch=脚趾紧缩
lower teeth only=仅下牙
cat paws=猫爪子
collared jacket=有领夹克
kunai=苦无
aran sweater=阿兰毛衣
purple bodysuit=紫色连体衣
grey vest=灰色背心
arm around shoulder=搂着肩膀
skirt suit=裙装
multiple wings=多个翅膀
rooftop=屋顶
two-tone fur=双色皮草
fog=多雾路段
chicken=鸡
cat boy=猫男孩
single leg pantyhose=单腿连裤袜
rei no himo=示例字符串
hypnosis=催眠
improvised gag=即兴插科打
neon trim=霓虹灯装饰
digital media player=数字媒体播放器
remote control=遥控
fishing rod=钓竿
copyright=版权
lightning bolt symbol=闪电符号
paradis military uniform=天堂军服
partially unzipped=部分解压缩
blue gemstone=蓝色宝石
what=什么
sleeves past elbows=袖子过肘
wizard hat=巫师帽
cake slice=蛋糕片
brand name imitation=仿名牌
kissing cheek=亲吻脸颊
rapier=剑杆
open door=开门
glowing weapon=发光的武器
leaning on person=靠在人身上
cage=笼
steepled fingers=尖顶手指
purple rose=紫玫瑰
print gloves=印花手套
elbow rest=肘托
grey hoodie=灰色连帽衫
green sailor collar=绿色水手领
holding bowl=拿着碗
orange flower=橙花
macaron=马卡龙
demon boy=恶魔男孩
flower-shaped pupils=花形瞳孔
food print=食物印刷品
keyboard (computer)=键盘（电脑）
single sleeve=单袖
needle=针
;q=;q
butt plug=对接塞
swimsuit aside=泳衣放在一边
pompadour=蓬巴杜
slave=奴隶
loose necktie=宽松的领带
print dress=印花连衣裙
hair tucking=卷发
shiny pokemon=闪亮的宠物小精灵
laevatein (touhou)=船舷（东方）
folded fan=折扇
opaque glasses=不透明眼镜
perky breasts=活泼的乳房
wrench=扳手
violin=小提琴
energy sword=能量剑
adjusting swimsuit=调整泳衣
stirrup legwear=马镫裤
naked sweater=裸毛衣
too many=太多
orange ribbon=橙色丝带
oppai loli=变量选项
egg vibrator=鸡蛋振动器
trefoil=三叶草
floor=地面
drum=鼓
american flag=美国国旗
armpit hair=腋毛
dancer=舞蹈家
framed breasts=陷害的乳房
pantylines=内裤线
sheep=羊
office chair=办公椅
lower body=下半身
policewoman=女警
afloat=漂浮
blue hakama=蓝色也是
sushi=寿司
mouse girl=老鼠女孩
cream=奶油
o-ring bottom=O形圈底部
mascara=睫毛膏
suction cups=吸盘
transformation=转型
train=火车
heart choker=心形项圈
hooded capelet=连帽披肩
lion tail=狮尾
holding towel=拿着毛巾
suit jacket=西装外套
contrail=轨迹
calligraphy brush=毛笔
excalibur (fate/stay night)=神剑（命运/住宿之夜）
reverse outfit=反装
multiple rings=多环
after anal=肛门后
tight pants=紧身裤
american flag dress=美国国旗裙
food on body=身体上的食物
striped tail=条纹尾巴
hair strand=发丝
hand under clothes=手在衣服下
bra removed=胸罩被移除
scope=范围
bandaids on nipples=乳头上的创可贴
left-handed=左撇子
paper bag=纸袋
uneven eyes=不均匀的眼睛
spacecraft=宇宙飞船
test tube=试管
duel=决斗
real life insert=现实生活插入
hand on own arm=手放在自己的胳膊上
hairpods=发夹
frilled gloves=褶边手套
blue capelet=蓝色披肩
stylus=手写笔
medical eyepatch=医用眼罩
map=地图
print bowtie=印花领结
staring=盯着
circle=圆圈
pink cardigan=粉色开衫
gym shorts=健身短裤
covered collarbone=遮盖锁骨
character profile=人物简介
blue scrunchie=蓝色发带
green leotard=绿色紧身衣
gradient sky=梯度天空
string of fate=命运之弦
concept art=概念艺术
lemon=柠檬
egyptian=埃及人
middle finger=中指
envelope=信封
no shirt=没有衬衫
footwear bow=鞋弓
holding mask=拿着面具
shotgun=散弹枪
rudder footwear=舵鞋
binoculars=望远镜
maid bikini=做比基尼
flashing=闪烁
father and son=父亲和儿子
mismatched gloves=不匹配的手套
fins=到
holding pokemon=拿着口袋妖怪
stage=阶段
hair beads=发珠
penis on face=阴茎在脸上
tomoe (symbol)=巴（符号）
partially undressed=部分脱衣服
pussy juice trail=猫汁踪迹
taur=公牛
squirrel ears=松鼠耳朵
stomach tattoo=腹部纹身
pussy juice stain=猫汁污渍
pink shorts=粉色短裤
rubber duck=橡皮鸭
dress bow=礼服蝴蝶结
pizza=比萨
basketball=篮球
capri pants=七分裤
holding camera=拿着相机
gloved handjob=戴手套打手枪
milestone celebration=里程碑庆典
furisode=振袖
arm belt=臂带
shore=支撑
multiple crossover=多重交叉
bandage over one eye=一只眼睛包扎
white vest=白色背心
horn bow=喇叭弓
chewing gum=口香糖
happy halloween=万圣节快乐
baozi=包子
pink leotard=粉色紧身连衣裤
multiple hair bows=多个发弓
drop shadow=投影
candy apple=糖苹果
striped bra=条纹文胸
open dress=开裙
finger gun=手指枪
background text=背景文字
digimon (creature)=数码宝贝（生物）
gothic=哥特
pumps=泵
body markings=身体标记
rod of remorse=悔恨之杖
lip biting=咬嘴唇
bad feet=坏脚
deep penetration=深度渗透
spitroast=烤肉
sake bottle=清酒瓶
blue pantyhose=蓝色连裤袜
humanization=人性化
red headband=红色头带
banner=横幅
duck=鸭子
heart-shaped eyewear=心形眼镜
uranohoshi school uniform=浦之星校服
arm rest=扶手
meiji schoolgirl uniform=明治女学生制服
parfait=完美的
swim trunks=泳裤
nightcap=睡帽
kindergarten uniform=幼儿园制服
reverse bunnysuit=反向兔衣
plaid dress=格子连衣裙
reverse suspended congress=反向暂停国会
grabbing another's ass=抓别人的屁股
ejaculating while penetrated=在插入时射精
cuts=削减
holding lollipop=拿着棒棒糖
breast slip=乳房滑
pink neckerchief=粉色围巾
tablet pc=平板电脑
obiage=服役
submerged=湮
forked eyebrows=分叉的眉毛
irrumatio=闯入
scar on chest=胸前的伤疤
energy gun=能量枪
bandaged hand=包扎的手
christmas ornaments=圣诞饰品
holding another's arm=挽着别人的胳膊
w arms=武器
lying on person=躺在人身上
goggles around neck=脖子上的护目镜
leotard aside=紧身衣放在一边
paint splatter=油漆飞溅
sandwich=三明治
piggyback=背驮式
upright straddle=直立跨骑
yellow scarf=黄围巾
anus peek=肛门窥视
purple vest=紫色背心
grey sailor collar=灰色水手领
green bra=绿色文胸
penis awe=阴茎敬畏
coat on shoulders=肩上的外套
pokephilia=恶作剧
chest harness=胸带
single sidelock=单边锁
lineup=排队
riding crop=策
black armor=黑色盔甲
polos crown=由皇冠
harpy=鹰身女妖
prosthetic arm=义肢
throwing=投掷
hair spread out=头发散开
colored pubic hair=有色阴毛
toy=玩具
clothes grab=衣服抢
hair twirling=头发捻转
viewfinder=取景器
single kneehigh=单膝高
squirrel tail=松鼠尾巴
hiding=隐藏
obliques=斜肌
leg hair=腿毛
holding box=收纳盒
midair=半空中
orange necktie=橙色领带
gae bolg (fate)=Gaye Bolg（撕裂）
tomato=番茄
furry with non-furry=毛茸茸的与非毛茸茸的
bird ears=鸟耳朵
holding underwear=拿着内衣
lion girl=狮子女
bat hair ornament=蝙蝠发饰
bone hair ornament=骨头发饰
frilled swimsuit=荷叶边泳衣
asymmetrical footwear=不对称鞋履
kuromorimine military uniform=黑森峰军装
chips (food)=薯片（食物）
hands on another's shoulders=把手放在另一个人的肩膀上
egasumi=阴霾
japari symbol=日本符号
layered bikini=莱尔德比基尼
hands on another's face=把手放在另一个人的脸上
reindeer antlers=驯鹿鹿角
blue-framed eyewear=蓝框眼镜
shooting star=流星
shovel=铲
heart in eye=心在眼里
seagull=海鸥
arm around waist=搂着腰
earbuds=耳塞
slime girl=史莱姆女孩
fighting=斗争
hands in opposite sleeves=双手放在相对的袖子里
sailor bikini=水手比基尼
speaker=扬声器
multi-tied hair=多扎头发
pubic hair peek=阴毛偷看
magazine (weapon)=杂志（武器）
darkness=黑暗
spoken squiggle=口语花体字
feather boa=羽毛围巾
mobile suit=机动战士
lifting person=举人
tiger girl=虎女
bleeding=流血的
shikishi=彩纸
leopard print=豹纹
miniboy=小男孩
star in eye=眼中的星星
grinding=打磨
loose belt=宽松的腰带
purple umbrella=紫色雨伞
after fellatio=口交后
gas mask=防毒面具
arms around neck=搂着脖子
raccoon girl=浣熊女孩
pancake=饼子
orange bodysuit=橙色连体衣
megaphone=扩音器
beer can=啤酒罐
deepthroat=深喉咙
jacket around waist=腰间夹克
grenade=手榴弹
red sleeves=红袖子
scowl=皱眉头
red belt=红腰带
goggles on headwear=头饰上的护目镜
letterman jacket=莱特曼夹克
horned headwear=有角的头饰
treble clef=高音谱号
bag charm=包包魅力
bubble tea=珍珠奶茶
vegetable=蔬菜
ceiling=天花板
soda can=汽水罐
alternate legwear=替代裤袜
licking finger=舔手指
clothed pokemon=穿衣服的宠物小精灵
finger on trigger=手指放在扳机上
newspaper=报纸
magazine cover=杂志封面
gloom (expression)=忧郁（表情）
leaf print=叶印
shirt tug=衬衫拖船
spoken interrobang=口语询问
hair tie in mouth=头发扎在嘴里
surreal=超现实的
bike shorts under skirt=裙子下的自行车短裤
orange sky=橙色的天空
bamboo forest=竹林
flip-flops=人字拖
guro=老师
in box=在盒子里
lily pad=蕸
long eyelashes=长长的睫毛
cross hair ornament=十字发饰
kanzashi=寒座
skates=拉屎
animal ear headphones=兽耳式耳机
orange hairband=橙色发带
constellation=星座
plantar flexion=跖屈
2020=2020
frying pan=平底锅
piano=钢琴
remote control vibrator=遥控振动器
ghost tail=鬼尾巴
yellow fur=黄色皮毛
in tree=在树上
city lights=城市的灯光
yellow rose=黄玫瑰
extra=额外的
thinking=思维
hagoromo=羽毛长袍
vertical-striped dress=竖条纹连衣裙
bunny print=兔子印花
holding scythe=拿着镰刀
sparkle background=闪光背景
stained glass=彩色玻璃
hand over own mouth=交出自己的嘴
snowflake hair ornament=雪花发饰
winged arms=带翅膀的武器
crotch rope=裆绳
food on head=头上的食物
5koma=5帧
peeing self=撒尿自我
sheep ears=羊耳朵
purple pantyhose=紫色连裤袜
holding axe=拿着斧头
traditional youkai=传统妖怪
mochi=年糕
candy cane=糖果手杖
au ra=对不起
kote=地方
quad tails=四尾
watson cross=沃森克罗斯
brown bag=棕色袋子
bar (place)=酒吧（地方）
thumb ring=指环
orange nails=橙色指甲
debris=碎片
bow-shaped hair=弓形头发
earclip=耳夹
uneven gloves=不平整的手套
public nudity=公开裸体
breast curtains=乳房窗帘
ankle ribbon=踝带
ribbed dress=罗纹连衣裙
arms under breasts=手臂在乳房下
left-to-right manga=从左到右的漫画
green scarf=绿色围巾
open-chest sweater=开胸毛衣
ear ribbon=耳带
flats=公寓
panda=熊猫
grey panties=灰色内裤
pith helmet=髓盔
writing=写作
bird on head=头上的鸟
diffraction spikes=衍射尖峰
neck ruff=领口
object namesake=对象同名
white scrunchie=白色发带
yellow kimono=黄色和服
heart in mouth=心在嘴里
button badge=按钮徽章
peeking=偷看
spill=洒
see-through shirt=透视衬衫
caterpillar tracks=履带
yugake=游挂
pink scrunchie=粉色发带
puppet=木偶
cupcake=纸杯蛋糕
breastless clothes=露胸衣服
paint=画
lotus=莲花
light green hair=淡绿色的头发
chained=链式
thank you=谢谢
american flag bikini=美国国旗比基尼
fur-trimmed hood=毛皮边罩
looking at penis=看着阴茎
gaping=张开
chemise=衬衫
arm hair=手臂毛
covering own eyes=遮住自己的眼睛
four-leaf clover=四叶草
wide ponytail=宽马尾辫
lace panties=蕾丝内裤
holding dagger=拿着匕首
numbered=编号的
shared clothes=共用衣服
chest sarashi=国际象棋暴露
shoe dangle=挂鞋
domino mask=多米诺面具
lotion=洗剂
shell casing=外壳
rubber boots=橡胶靴
medal=勋章
exercise=锻炼
collage=拼贴画
green hairband=绿色发带
hallway=门厅
mitsudomoe (shape)=三巴（形状）
cheese=奶酪
tunic=束腰外衣
layered clothes=分层衣服
on shoulder=在肩膀上
bento=便当
stuffed cat=毛绒猫
red gemstone=红色宝石
black ascot=黑色领带
ears down=竖起耳朵
shoulder carry=肩扛
orange footwear=橙色鞋类
cat ear panties=猫耳内裤
two-tone skirt=双色裙
gekkoukan high school uniform=Gekko Tamaki Cost gh 由 Unifor rm 编写
paw shoes=爪子鞋
huge nipples=巨大的乳头
yunomi=茶碗
pinching=捏
rabbit hood=兔子罩
moonlight=月光
pirate=海盗
hand on another's chest=手放在别人的胸口
snot=鼻涕
stethoscope=听诊器
corruption=腐败
red sclera=红色巩膜
mole on thigh=大腿上的痣
single detached sleeve=单袖
keyhole=锁孔
world war ii=第二次世界大战
bangs pinned back=刘海向后固定
striker unit=前锋单位
latin cross=拉丁十字
qing guanmao=请官帽
pillarboxed=邮筒式
subtitled=字幕
aiming at viewer=瞄准观众
urethra=尿道
volleyball=排球
helmet removed=摘下头盔
torn bodysuit=撕裂的紧身连衣裤
blue belt=蓝带
horseshoe ornament=马蹄形饰品
dice=骰子
fetal position=胎位
vibrator under clothes=衣服下的振动器
kyuubi=九尾
trash can=垃圾箱
rose print=玫瑰印花
chainsaw=链锯
bra peek=胸罩偷看
hip bones=髋骨
goldfish=金鱼
leg lock=腿锁
breast tattoo=胸部纹身
torn sleeves=撕裂的袖子
jealous=嫉妒的
purple choker=紫色项圈
pink apron=粉色围裙
green thighhighs=绿色长筒袜
year of the tiger=虎年
purple wings=紫色的翅膀
profanity=亵渎
kogal=作为凝胶
wedding=婚礼
doorway=门口
gem uniform (houseki no kuni)=宝石制服（宝石之国）
ramen=拉面
crescent earrings=新月形耳环
flat ass=扁屁股
ladder=梯子
hand in panties=交上内裤
wet swimsuit=湿泳衣
pudding=布丁
sword of hisou=飞翔之剑
over-rim eyewear=超框眼镜
alternate universe=平行宇宙
soccer ball=足球
coattails=燕尾服
feather trim=羽毛装饰
padlock=挂锁
multiple horns=多角
abstract=抽象的
seamed legwear=接缝裤袜
soldier=士兵
quarter note=四分音符
wa maid=和女仆
bullpup=斗牛犬
white robe=白袍
burn scar=烧伤疤痕
diagonal bangs=斜刘海
fashion=时尚
crossed ankles=脚踝交叉
wide spread legs=宽张开的腿
pant suit=裤装
flaming eye=燃烧的眼睛
nervous smile=紧张的微笑
electric fan=电扇
paddle=桨
zombie pose=僵尸姿势
lifted by another=被另一个举起
skirt tug=裙子拖船
bass guitar=低音吉他
owl=猫头鹰
clitoral stimulation=阴蒂刺激
grey coat=灰色外套
snowflake print=雪花印花
orgy=狂欢
hand on another's hip=把手放在别人的臀部
spade (shape)=铲子（形状）
linea alba=日出线
sleepwear=睡衣
heart pillow=心枕
holding pom poms=拿着绒球
strap between breasts=胸带
shower head=花洒头
year of the ox=牛年
pink bodysuit=粉色连体衣
sunburst=朝阳
duffel bag=行李袋
turtle shell=鳖甲
finger to cheek=手指贴脸颊
orange gloves=橙色手套
multiple belts=多带
green sweater=绿色毛衣
mismatched bikini=不匹配的比基尼
eyepatch bikini=眼罩比基尼
sheep girl=羊女
weibo username=微博用户名
2018=2018
happy valentine=情人节快乐
pig=猪
mouth drool=流口水
chef hat=老板有
red pupils=红色的瞳孔
black cardigan=黑色开衫
anime coloring=动漫着色
frilled hair tubes=褶边发管
shark=鲨鱼
locker room=更衣室
santa bikini=圣诞老人比基尼
negligee=忽视
striped jacket=条纹夹克
2019=2019
talons=利爪
seashell=贝壳
come hither=到这里来
st. gloriana's school uniform=英石。格洛丽亚娜的校服
g-string=G弦
frilled kimono=荷叶边和服
2016=2016
orange scrunchie=橙色发带
shibari over clothes=绑起来
brown theme=棕色主题
prone bone=俯卧骨
embers=余烬
scar on arm=手臂上的伤疤
giving=给予
animal penis=动物阴茎
green coat=绿大衣
doll hug=娃娃拥抱
yellow scrunchie=黄色发带
suspension=暂停
bandaid on pussy=创可贴上的猫
horizontal pupils=水平瞳孔
cold=寒冷的
wrestling outfit=摔跤装
ainu clothes=阿伊努人的衣服
mismatched footwear=不匹配的鞋子
scar on nose=鼻子上的伤疤
white theme=白色主题
alternate headwear=备用头饰
flame-tipped tail=火焰尾巴
sitting on face=坐在脸上
nipple rings=乳环
spacesuit=宇航服
multiple earrings=多个耳环
cum on stomach=暨在肚子上
untied panties=解开内裤
clothes in mouth=衣服含在嘴里
blade=刀刃
sigh=叹
cigar=雪茄
ribbed shirt=罗纹衬衫
shirt removed=脱下衬衫
raincoat=雨衣
two-tone jacket=双色夹克
updo=发髻
pastry=糕点
holding panties=拿着内裤
arm around neck=搂着脖子
black headband=黑色头带
orange choker=橙色项圈
head-mounted display=头戴式显示器
two-footed footjob=两足脚交
lights=灯
walk-in=步入
dog boy=狗男孩
arm held back=手臂被挡住
still life=静物
checkered scarf=方格围巾
holding flag=拿着旗帜
hand on another's back=把手放在别人的背上
sweets=糖果
mallet=槌
bloom=盛开
spandex=氨纶
hand on another's arm=把手搭在别人的胳膊上
bow bikini=蝴蝶结比基尼
kitauji high school uniform=北宇治高中制服
spotlight=聚光灯
undersized clothes=尺寸过小的衣服
naoetsu high school uniform=直江津高中制服
sun symbol=太阳符号
skirt around one leg=裙子绕在一条腿上
magazine (object)=杂志（对象）
red sash=红腰带
shouji=手机
white feathers=白色的羽毛
hand grab=手抓
shaved ice=刨冰
open shorts=开短裤
puckered lips=皱起的嘴唇
open collar=开领
suspender shorts=吊带短裤
skull and crossbones=骷髅和交叉骨
plastic bag=塑料袋
typo=打字错误
tombstone=墓碑
hairy=毛茸茸
2015=2015
zero suit=零花色
super saiyan=超级赛亚人
ooarai military uniform=大洗军装
thigh sex=大腿性
jackal ears=豺耳
orange theme=橙色主题
bodysuit under clothes=衣服下面的连体衣
cube hair ornament=立方体发饰
tuxedo=燕尾服
carpet=地毯
calendar (medium)=日历（中）
heart tattoo=心脏纹身
screaming=尖叫
cum on boy=暨男孩
mohawk=莫霍克族
look-alike=看起来像
bandaid on cheek=脸颊上的创可贴
toothbrush=牙刷
on lap=在腿上
swirl lollipop=漩涡棒棒糖
rubbing eyes=揉眼睛
small penis=小阴茎
black fur=黑色皮毛
rice bowl=饭碗
flower pot=花盆
dusk=黄昏
green cape=绿斗篷
female pov=女性视角
striped socks=条纹袜子
number tattoo=数字纹身
hadanugi dousa=如果你不
egyptian clothes=埃及的衣服
orc=兽人
o3o=一个
brown ribbon=棕丝带
grey sky=灰色的天空
tally=相符
flask=烧瓶
2017=2017
princess=公主
club (weapon)=俱乐部（武器）
hexagram=六芒星
holding smoking pipe=拿着烟斗
patterned background=图案背景
phimosis=包茎
nape=颈背
bit gag=有点堵嘴
squirrel girl=松鼠女孩
condom on penis=阴茎上的避孕套
uneven sleeves=袖子参差不齐
red one-piece swimsuit=红色连体泳衣
purple sleeves=紫袖
black bag=黑色包
evening gown=晚礼服
beach towel=沙滩巾
power symbol=权力符号
:i=：我
smell=闻
side cutout=侧面镂空
big belly=大肚子
bomber jacket=飞行员夹克
cat ear headphones=猫耳耳机
convenient arm=方便的手臂
futa with male=futa 与 男性
cameo=客串
talisman=护符
creator connection=创作者联系
tam o' shanter=唐欧山儿
asphyxiation=窒息
blue lips=蓝色的嘴唇
carrot necklace=胡萝卜项链
red pantyhose=红色连裤袜
d-pad=方向键
drumsticks=鸡腿
police hat=警察帽
monkey tail=猴尾巴
broken glass=碎玻璃
triangle=三角形
white headband=白色头带
sink=下沉
path=小路
sunrise=日出
diagonal-striped bow=斜条纹蝴蝶结
smiley face=笑脸
mouse (computer)=鼠标（电脑）
purple pants=紫色裤子
millipen (medium)=毫笔（中号）
roman numeral=罗马数字
tail through clothes=穿过衣服的尾巴
tied up (nonsexual)=捆绑（非性）
cover image=封面图片
disembodied head=无实体的头
plum blossoms=梅花
pink-framed eyewear=粉框眼镜
enpera=恩佩拉
cyberpunk=赛博朋克
covered abs=覆盖腹肌
hill=爬坡道
faux traditional media=仿传统媒体
steam censor=蒸汽检查器
shoulder spikes=肩钉
rectangular eyewear=长方形眼镜
green choker=绿色项圈
coffee cup=咖啡杯
desert=沙漠
curry=咖喱
shimakaze (kancolle) (cosplay)=Shimakaze（Kanko）（小喷）
ice cube=冰块
beak=喙
russian text=俄语文本
trick or treat=不给糖就捣蛋
black scrunchie=黑色发带
quill=鹅毛笔
spider web print=蜘蛛网打印
diadem=冠冕
ufo=飞碟
fur coat=皮毛大衣
shuuchiin academy school uniform=修知院校服
tree shade=树阴
bird girl=鸟女
holding sheath=持鞘
black tail=黑色的尾巴
scratches=划痕
strangling=扼杀
finger in another's mouth=手指在别人的嘴里
microdress=微礼服
anal fingering=肛门指法
matching outfit=配套服装
fourth wall=第四堵墙
clitoral hood=阴蒂罩
hamster=仓鼠
holding arrow=拿着箭头
neck tattoo=颈部纹身
cyclops=独眼巨人
short sword=短剑
shared scarf=共用围巾
sitting on desk=坐在办公桌上
praying=祈祷
cervix=宫颈
tri tails=三尾巴
eraser=橡皮
string of flags=一串旗帜
driving=驾驶
jellyfish=海蜇
diving mask=潜水面具
retrofit (azur lane)=改造（碧蓝航线）
bad hands=坏手
tribadism=部落主义
aqua bikini=水上比基尼
??=??
torn cape=撕裂的斗篷
multicolored legwear=五彩裤袜
chinese knot=中国结
octarian=八角
tennis uniform=网球服
dirty face=脏脸
evolutionary line=进化线
ankle cuffs=脚踝袖口
black camisole=黑色吊带背心
sideless outfit=无边装
large tail=大尾巴
phone screen=手机屏幕
restaurant=餐厅
feather hair=羽毛头发
spatula=抹刀
mechanical parts=机械零件
white cat=白猫
cooperative fellatio=合作口交
breast bondage=乳房束缚
blue ascot=蓝色阿斯科特
colored tongue=彩色舌头
two-tone bikini=双色调比基尼
torch=火炬
melting=融化
satchel=书包
looking at object=看着物体
calendar (object)=日历（对象）
jet=喷射
ribbed legwear=罗纹裤袜
crossed bandaids=交叉创可贴
chain necklace=项链
cliff=悬崖
white nails=白指甲
strappy heels=系带高跟鞋
red umbrella=红伞
hand on hilt=把手放在刀柄上
shark hair ornament=鲨鱼发饰
insignia=徽章
crotchless panties=开裆裤
prayer beads=念珠
kabedon=沃尔唐
shading eyes=遮住眼睛
studded belt=铆钉腰带
purple shorts=紫色短裤
feather-trimmed sleeves=羽毛边袖
starter pokemon trio=新手口袋妖怪三人组
spoken anger vein=口语怒脉
milk bottle=奶瓶
fur-trimmed legwear=皮草边饰裤袜
oni mask=我是面具
multicolored wings=五彩的翅膀
hair horns=发角
dessert=甜点
dynamax band=极力带
samurai=武士
striped pants=条纹裤
smelling=闻
ear tag=耳标
blue cardigan=蓝色开衫
harem outfit=后宫装
caught=捕捉
creature and personification=生物和拟人化
bare hips=裸露的臀部
hikarizaka private high school uniform=光坂私立高中制服
sleeping upright=直立睡觉
cave=洞穴
fine art parody=美术模仿
arabian clothes=阿拉伯服装
white cloak=白斗篷
black apron=黑围裙
curtain grab=窗帘抢
open skirt=开裙
horseback riding=骑马
two-tone swimsuit=双色泳装
liquid=液体
whistle around neck=脖子上吹口哨
d-pad hair ornament=d-pad发饰
ritual baton=仪式指挥棒
wire=金属丝
keyboard (instrument)=键盘（乐器）
yoga pants=瑜珈裤
hands on own head=双手放在自己的头上
lace-trimmed dress=蕾丝边连衣裙
bolt action=螺栓行动
strapless bra=无肩带文胸
racket=球拍
winged hat=带翅膀的帽子
holding condom=拿着避孕套
tailcoat=燕尾服
drawing tablet=绘图板
no eyewear=没有眼镜
abstract background=抽象背景
pulled by another=被另一个拉
purple cape=紫色斗篷
sweater around waist=毛衣围腰
hooded cape=连帽斗篷
broken horn=断角
magical musket=神奇的火枪
mega pokemon=眼睛口袋妖怪
church=教会
gold chain=金链子
holding doll=抱着娃娃
graffiti=涂鸦
naked coat=裸衣
tie clip=领带夹
dreadlocks=辫子
flower (symbol)=花（符号）
town=镇
attack=攻击
black lips=黑嘴唇
green lips=绿色的嘴唇
long pointy ears=长而尖的耳朵
twitching penis=抽搐的阴茎
pill=丸
light bulb=灯泡
when you see it=你看到它的时候
;3=;3
arch=拱
butterfly print=蝴蝶印花
carrying over shoulder=扛在肩上
black rose=黑玫瑰
french fries=炸薯条
omelet=煎蛋卷
mechanical legs=机械腿
instant loss=瞬间损失
festival=节日
single hair intake=单发摄入量
anzio school uniform=azio 校服
rocket launcher=火箭发射器
patterned clothing=有图案的衣服
pulling=拉
grey bow=灰色蝴蝶结
> o=> 的
holding sign=举牌子
spilling=溢出
purple scarf=紫色围巾
hand on another's thigh=把手放在别人的大腿上
two-tone gloves=双色手套
tankini=坦基尼
vial=小瓶
st. gloriana's military uniform=英石。荣耀的军装
belly chain=腹链
impossible leotard=不可能的紧身衣
single vertical stripe=单竖条纹
white cardigan=白色开衫
cat print=猫印
stage lights=舞台灯
plaid bikini=格子比基尼
glowstick=发光棒
nail=指甲
surfboard=冲浪板
laurel crown=桂冠
spread wings=张开翅膀
sweatband=防汗带
video camera=录影机
trumpet=喇叭
reverse upright straddle=反向直立跨骑
fleeing=逃离
flower earrings=花耳环
bandaged head=包扎头
product placement=物品陈设
moss=苔藓
budget sarashi=裸露
turban=头巾
energy wings=能量之翼
plunging neckline=低领口
official alternate hair length=官方备用头发长度
penis grab=阴茎抓
thigh ribbon=大腿丝带
briefs=内裤
clothes hanger=衣架
mini-hakkero=米妮八卦炉
see-through legwear=透视裤袜
cat hat=猫帽
hammer and sickle=锤子和镰刀
tongue piercing=舌头穿孔
head grab=抢头
standing on liquid=站在液体上
egg (food)=鸡蛋（食物）
spiked armlet=尖刺臂章
denim skirt=牛仔裙
covering nipples=覆盖乳头
blur censor=模糊检查器
monocle hair ornament=单片眼镜发饰
spread fingers=张开手指
porkpie hat=猪肉派有
orange shorts=橙色短裤
oversized animal=超大动物
aqua skirt=水色裙
clothes down=衣服下来
veranda=阳台
dust=灰尘
finger in own mouth=手指在自己的嘴里
manga (object)=漫画（对象）
spanked=打屁股
tusks=象牙
fur scarf=毛皮围巾
black feathers=黑色羽毛
stray pubic hair=散乱的阴毛
vertical-striped skirt=竖条纹半身裙
hands on headwear=手放在头饰上
ankle socks=脚踝袜
potato chips=土豆片
pool ladder=泳池梯子
feather earrings=羽毛耳环
sleep molestation=睡眠骚扰
car interior=汽车内饰
tail bell=尾铃
on table=桌上
gown=袍
blue serafuku=蓝色六翼天使
naked sheet=裸床单
false smile=假笑
whale=鲸
mop=拖把
ribbon-trimmed skirt=缎带边饰半身裙
santa dress=圣诞老人礼服
bowl hat=碗帽
pocky day=百日
shako cap=可以盖
kappougi=卡普伊吉
mechanical horns=机械喇叭
low twin braids=低双辫子
dreaming=做梦
median furrow=中间沟
korean clothes=韩服
sketchbook=速写本
purple coat=紫色外套
back tattoo=背部纹身
nose bubble=鼻泡
tanuki=狸猫
tegaki=手写
child on child=孩子对孩子
sweet potato=甘薯
have to pee=必须撒尿
scissor blade=剪刀刀片
nib pen (medium)=尖头笔（中号）
boxing gloves=拳击手套
orange kimono=橙色和服
shuriken=飞镖
black sports bra=黑色运动文胸
birthday cake=生日蛋糕
bunny pose=兔子姿势
clover hair ornament=三叶草发饰
wife and wife=妻子和妻子
covered face=蒙面
crotch rub=擦裆
high contrast=高对比度
black hakama=黑色也是
borrowed garments=借来的衣服
clothed animal=穿衣服的动物
gusset=扣板
wooden bucket=木桶
wind chime=风铃
pillow grab=抱枕
impossible bodysuit=不可能的连体衣
pink sleeves=粉色袖子
mating press=配套压力机
hands on lap=双手放在膝上
grimace=鬼脸
turtle=龟
inflatable toy=充气玩具
wreath=花圈
afro=爆炸头
transparent umbrella=透明伞
dyed bangs=染刘海
taiyaki=鲷鱼烧
glowing sword=发光的剑
nengajou=新年贺卡
team rocket=火箭队
juice box=果汁盒
drawer=抽屉
setsubun=节分
baseball=棒球
prehensile hair=卷发
picture (object)=图片（对象）
bad proportions=比例不好
slime (creature)=粘液（生物）
vocaloid append=声乐附加
three-dimensional maneuver gear=三维机动装置
holding cat=抱着猫
hand in another's hair=插别人的头发
symmetry=对称
cube=立方体
school hat=学生帽
bite mark=咬痕
earpiece=听筒
crepe=绉
corpse=尸体
tokkuri=清酒瓶
skewer=串
counter=柜台
beamed sixteenth notes=十六分音符
scepter=权杖
boxers=拳击手
wrestling=摔角
brown cape=棕色斗篷
comb=梳子
shark hood=鲨鱼兜帽
holding sack=拿着麻袋
holding controller=持有控制器
grey-framed eyewear=灰框眼镜
holding basket=拿着篮子
clothed masturbation=衣服手淫
hanfu=汉服
warship=军舰
ankle lace-up=脚踝系带
diamond-shaped pupils=菱形瞳孔
in bucket=在桶里
green gemstone=绿色宝石
playing with own hair=玩自己的头发
cheek pinching=捏脸颊
flute=长笛
tripping=绊倒
shared umbrella=共用雨伞
red sky=红色的天空
cocktail glass=鸡尾酒杯
spinning=纺纱
between thighs=大腿之间
swim briefs=泳裤
on grass=在草地上
mod3 (girls' frontline)=mod3（少女前线）
parted hair=分开的头发
failure=失败
grey socks=灰色袜子
barrel=桶
light trail=光迹
multicolored bodysuit=五彩连体衣
hyur=久尔
sports bikini=运动比基尼
sleeveless sweater=无袖毛衣
hair through headwear=头发穿过头饰
column lineup=专栏阵容
multicolored swimsuit=五彩泳装
candlestand=烛台
vending machine=售货机
turnaround=回转
purple sweater=紫色毛衣
safety pin=别针
spider girl=蜘蛛女
holding paintbrush=拿着画笔
toast=吐司
impregnation=浸渍
daisy=雏菊
large hat=大帽子
burning=燃烧
head back=返回
cheek poking=脸颊戳
volleyball uniform=排球服
hands on another's head=把手放在别人的头上
torn shorts=破短裤
squid=乌贼
censored nipples=审查乳头
lion=狮子
bisexual female=双性恋女性
aqua dress=水蓝色连衣裙
fewer digits=更少的数字
balcony=阳台
eye mask=眼罩
caustics=焦散
ribbon-trimmed clothes=缎带衣服
looking over eyewear=看着眼镜
yellow choker=黄色项圈
heart hands duo=心手二人组
scar on forehead=额头上的伤疤
face to breasts=面对乳房
overskirt=罩裙
stone=石头
union jack=联盟杰克
striped sleeves=条纹袖
multiple condoms=多个避孕套
nose piercing=鼻子穿孔
holding drink=拿着饮料
energy ball=能量球
soap=肥皂
ok sign=好的标志
licking nipple=舔乳头
white male underwear=白色男内裤
humanoid robot=人形机器人
prostitution=卖淫
two-tone bowtie=双色领结
chaps=伙计们
under table=桌子底下
gate=门
strawberry shortcake=草莓脆饼
blood stain=血迹
cosmetics=化妆品
alarm clock=闹钟
harvin=哈文
multicolored gloves=五彩手套
lace bra=蕾丝文胸
head bump=撞头
69=69
keychain=钥匙链
polka dot bra=圆点好
ceiling light=天花灯
flower wreath=花环
fried egg=煎鸡蛋
yellow vest=黄色背心
industrial pipe=工业管
clover print=三叶草印花
snake tail=蛇尾
naked cape=裸斗篷
rug=小地毯
dominatrix=母夜叉
lemon slice=柠檬片
tissue=组织
spear the gungnir=长矛 gungnir
squirrel=松鼠
bound ankles=绑脚踝
deer ears=鹿耳
looking at phone=看着电话
jack-o' challenge=jack-o' 挑战
shrimp=虾
magatama necklace=勾玉项链
traffic light=红绿灯
thick arms=粗壮的手臂
if they mated=如果他们交配
rainbow order=彩虹订单
chart=图表
star choker=星星项圈
brown sailor collar=棕色水手领
watering can=喷壶
orange scarf=橙色围巾
akeome=苏梅
pointer=指针
finger to own chin=手指到自己的下巴
train station=火车站
holding hammer=拿着锤子
sleeping on person=睡在人身上
footprints=脚印
bandaid on arm=手臂上的创可贴
pearl (gemstone)=珍珠（宝石）
happy tears=幸福的眼泪
checkered necktie=格纹领带
yellow bra=黄色文胸
harem=后宫
checkered kimono=方格和服
breast curtain=胸帘
against tree=反对树
two-tone ribbon=双色丝带
holding syringe=拿着注射器
whisk=拂
plaid necktie=格子领带
condom packet strip=安全套包条
fluffy=蓬松的
bomb=炸弹
color guide=颜色指南
refrigerator=冰箱
hairdressing=理发
aqua bowtie=水绿色领结
hitachi magic wand=日立魔法棒
cracked skin=龟裂的皮肤
skull earrings=骷髅耳环
chasing=追逐
circle cut=圆切
cross scar=交叉疤痕
tape gag=胶带堵嘴
poncho=雨披
dirty clothes=脏衣服
champagne flute=香槟长笛
rabbit house uniform=兔舍制服
drill=钻头
brown capelet=棕色披肩
you're doing it wrong=你这样做是错的
shared food=共享食物
purple sailor collar=紫色水手领
plectrum=吉他拨片
cheating (relationship)=作弊（关系）
drone=无人机
non-humanoid robot=非人形机器人
loose clothes=宽松的衣服
homurahara academy school uniform=小焰原学园校服
faucet=龙头
m4 carbine=m4卡宾枪
board game=棋盘游戏
after kiss=接吻后
sidesaddle=侧鞍
sticker=贴纸
cafe=咖啡店
in food=在食物中
alley=胡同
spoken sweatdrop=口语汗珠
pale color=苍白的颜色
:x=：X
identity censor=身份审查员
aqua ribbon=水色丝带
strawberry print=草莓印花
destruction=破坏
purple sky=紫色的天空
gatling gun=加特林机枪
tennis racket=网球拍
railroad tracks=铁轨
bandage on face=脸上的绷带
eye focus=眼睛焦点
white horns=白角
stripper pole=脱衣舞极
drill locks=钻锁
cockpit=座舱
dixie cup hat=迪克西杯帽
crossbow=弩
legwear garter=吊袜带
monkey=猴
beltbra=腰带文胸
starry sky print=星空印花
birdcage=鸟笼
futanari masturbation=双性人成
anti-materiel rifle=内部 RFL
character print=字符打印
holly=冬青
mask pull=面具拉
animal feet=动物脚
doyagao=的哦牙膏
pond=池塘
cloud print=云打印
red socks=红袜子
alternate form=替代形式
butler=管家
winged helmet=有翼头盔
pink hoodie=粉色连帽衫
dove=在哪里
frilled capelet=褶边披肩
mixed media=混合媒体
fanny pack=腰包
hooves=蹄子
swing=摇摆
fellatio gesture=口交手势
song name=歌名
open bra=打开好
strapless shirt=露肩衬衫
variations=变化
hands on own thighs=双手放在自己的大腿上
deviantart username=deviantart用户名
gold earrings=金耳环
yellow-framed eyewear=黄框眼镜
impossible dress=不可能的衣服
briefcase=公文包
blue apron=蓝色围裙
see-through dress=透视连衣裙
fishing=钓鱼
rubble=瓦砾
black robe=黑袍
tickling=挠痒痒的
spitting=随地吐痰
spider=蜘蛛
naked jacket=裸夹克
pocky kiss=百奇之吻
radio antenna=收音机天线
buck teeth=獠牙
body hair=体毛
pussy juice puddle=猫汁水坑
mace=女士
character hair ornament=人物发饰
adjusting gloves=调整手套
ink=墨水
holding pencil=拿着铅笔
high-waist pants=高腰裤
missile=导弹
straitjacket=紧身衣
artificial vagina=人工阴道
multicolored bikini=五彩比基尼
chain leash=链带
selfcest=自我庆祝
frilled ribbon=褶边丝带
o-ring choker=O 型环项圈
leg belt=腿带
mimikaki=挖耳勺
sparks=火花
skin fangs=皮肤毒牙
other focus=其他焦点
tube=管子
pole dancing=钢管舞
see-through leotard=透明紧身连衣裤
bird on hand=手边的鸟
roller skates=溜冰鞋
red hoodie=红色连帽衫
holding leash=牵着皮带
super robot=超级机器人
eastern dragon=东龙
fine fabric emphasis=精细面料强调
surprise kiss=惊喜之吻
puffy shorts=蓬松短裤
beam rifle=光束步枪
no wings=没有翅膀
helm=舵
barcode tattoo=条形码纹身
brushing hair=梳理头发
patch=修补
high-waist shorts=高腰短裤
dolphin=海豚
pokemon on head=头上的口袋妖怪
cabinet=内阁
cowboy western=西部牛仔
red armor=红色盔甲
kalashnikov rifle=卡拉什尼科夫步枪
skull print=头骨打印
implied futanari=暗含扶她那里
pain=疼痛
confused=使困惑
sitting in tree=坐在树上
breasts on head=头上的乳房
reflective floor=反光地板
through clothes=透过衣服
worried=担心
instrument case=仪器箱
on person=亲自
freediving=免费潜水
crescent facial mark=月牙纹
gorget=护喉
fox boy=狐狸精
nail art=美甲
yellow thighhighs=黄色长筒袜
torpedo tubes=鱼雷发射管
aerial fireworks=空中烟花
\||/=\||/
latex bodysuit=乳胶连体衣
star halo=星星你好
cherry blossom print=樱花印花
tanabata=七夕
yellow cardigan=黄色开衫
x x=××
leopard ears=豹耳
poke ball symbol=戳球符号
lip piercing=嘴唇穿孔
circle name=圈名
wooden sword=木剑
spread toes=张开脚趾
red cloak=红斗篷
coral=珊瑚
cowlick=女牛仔
white suit=白西装
seigaiha=青海波
tangzhuang=唐装
kuromorimine school uniform=黑森峰校服
light areolae=浅乳晕
breast smother=乳房窒息
menu=菜单
monsterification=怪物化
after paizuri=af 手 r 奶操
wing hair ornament=翅膀发饰
mismatched pupils=不匹配的学生
greatsword=巨剑
cousins=表亲
voyakiloid=voyakiloid
ofuda on clothes=衣服上的豆田
plaid background=格子背景
white sash=白腰带
shinsengumi=新选组
holstered weapon=枪套武器
very long fingernails=很长的指甲
jirai kei=地雷系统
confession=忏悔
tactical clothes=战术服
autobot=汽车人
dress tug=礼服拖船
leaning on object=靠在物体上
blinds=百叶窗
ribbon bondage=丝带束缚
tokusatsu=德摄
milk carton=牛奶盒
insect wings=昆虫的翅膀
patchwork skin=拼布皮肤
thighhighs pull=长腿拉
baseball uniform=棒球服
spring (season)=春暖花开的季节）
flexing=弯曲
yasogami school uniform=yasogami校服
hand on own leg=手放在自己的腿上
plaid bowtie=格子领结
polka dot dress=波点连衣裙
untucked shirt=解开衬衫
bondage outfit=束缚装
stuck=卡住
green hoodie=绿色连帽衫
breasts on glass=玻璃上的乳房
beckoning=招手
icho private high school uniform=icho私立高中制服
biker clothes=骑自行车的衣服
pink vest=粉色背心
marker=标记
holding whip=拿着鞭子
german clothes=德国衣服
pawpads=爪垫
scarlet devil mansion=红魔馆
wooden wall=木墙
hikimayu=明智的
very long sleeves=很长的袖子
magatama earrings=睡眠耳环
grabbing another's chin=捏着别人的下巴
park bench=公园的长椅上
hair brush=毛刷
messy=凌乱的
medium dress=中号连衣裙
in the face=在脸上
star necklace=星星项链
palms=手掌
moon (ornament)=月亮（摆设）
full nelson=全纳尔逊
torn=撕裂
wheel=车轮
tarot=塔罗牌
teasing=戏弄
incoming gift=收到的礼物
naginata=薙刀
diamond button=菱形按钮
green-framed eyewear=绿框眼镜
leotard pull=紧身衣拉
color connection=颜色连接
cuddling=拥抱
gold hairband=金发带
horned helmet=角盔
pencil dress=铅笔裙
scene reference=场景参考
cucumber=黄瓜
elite ii (arknights)=精英 ii（明日方舟）
viera=信仰
different reflection=不同的反映
bear hair ornament=熊发饰
single pauldron=单肩甲
fortissimo=非常强壮
barbell piercing=杠铃穿孔
fish girl=鱼女
unconscious=无意识
claw (weapon)=爪（武器）
chandelier=枝形吊灯
petting=抚摸
chocolate bar=巧克力吧
2014=2014
dowsing rod=探测棒
role reversal=角色反转
hair in mouth=嘴里的头发
projected inset=投影插图
taut dress=紧身连衣裙
choko (cup)=巧克力（可可）
embellished costume=装饰服装
fff threesome=三人行
fighter jet=战斗机
heckler & koch=质问者
mechanical pencil=自动铅笔
polo shirt=Polo衫
health bar=健康栏
puffy detached sleeves=蓬松的袖子
cropped vest=七分背心
ushanka=乌尚卡
suppressor=抑制器
leg hold=抱腿
green neckerchief=绿色围巾
pink pants=粉色裤子
futa with futa=futa 与 futa
stiletto heels=细高跟鞋
two-handed=双手的
cupless bra=无杯好
handsfree ejaculation=免提射精
nontraditional playboy bunny=非传统的花花公子兔子
black mask=黑面具
lounge chair=躺椅
bikini top removed=比基尼上衣被移除
spine=脊柱
old woman=老太婆
tall female=高个女
strap-on=捆绑式
holding lantern=拿着灯笼
crotch plate=裆板
faux figurine=人造雕像
graveyard=墓地
shallow water=浅水区
holding stick=拿着棍子
striped gloves=条纹手套
poke ball print=戳球打印
aqua theme=水色主题
hakurei reimu (cosplay)=博丽灵梦（小间谍）
perineum=会阴
neon lights=霓虹灯
groin tendon=腹股沟肌腱
reindeer costume=驯鹿服装
visible air=可见空气
mars symbol=火星符号
whipped cream=生奶油
hagoita=讨价还价
wolf boy=狼孩
lipstick tube=口红管
red cross=红十字
large insertion=大插入
bowing=鞠躬
staff (music)=工作人员（音乐）
crazy smile=疯狂的微笑
shikigami=式神
sorcerer's sutra scroll=巫师经卷
holding clipboard=拿着剪贴板
german text=德语文本
fireflies=萤火虫
office=办公室
notepad=记事本
jacket partially removed=夹克部分被移除
sunburst background=森伯斯特背景
wisteria=紫藤
checkerboard cookie=棋盘饼干
presenting armpit=呈现腋窝
head between breasts=乳房之间的头
spiked tail=尖刺的尾巴
aqua shirt=水蓝色衬衫
bamboo broom=竹扫帚
gem (symbol)=宝石（符号）
single gauntlet=单手套
eagle=鹰
bishamonten's pagoda=毗沙门天塔
video game=电子游戏
reach-around=伸手可及
pantyhose under shorts=短裤下的连裤袜
black sash=黑色腰带
frilled cuffs=荷叶边袖口
air conditioner=冷气机
fish hair ornament=鱼发饰
green apron=绿色围裙
ramune=弹丸
grey scarf=灰色围巾
simplified chinese text=简体中文
fingers=手指
pacifier=安抚奶嘴
sword over shoulder=肩上的剑
beach chair=沙滩椅
stationary restraints=固定约束
fallen down=倒下了
hand on another's ass=把手放在别人的屁股上
stuffed shark=毛绒鲨鱼
naked hoodie=裸连帽衫
mouth veil=口纱
mahjong=麻将
collared cape=有领斗篷
hexagon=六边形
kusazuri=除草
santa boots=圣诞靴
pentacle=五角星
tan background=棕褐色背景
white-framed eyewear=白框眼镜
circled 9=圈出9
japanese flag=日本国旗
power suit=动力套装
reference inset=参考插图
nijigasaki academy school uniform=虹崎学园校服
caressing testicles=爱抚睾丸
narrowed eyes=眯起眼睛
painting (action)=绘画（动作）
hooded sweater=连帽衫
pink one-piece swimsuit=粉色连体泳衣
lipstick mark=口红印
clothed female nude female=穿衣女 裸体女
ribbon-trimmed collar=缎带领
age progression=年龄进展
tulip hat=郁金香帽
dinosaur=恐龙
kissing forehead=亲吻额头
earth (ornament)=地球（装饰品）
yellow skin=黄皮肤
grey fur=灰色皮毛
sports car=跑车
tail censor=尾部审查员
love letter=爱情信
thigh pouch=大腿袋
pink blood=粉红色的血
caution tape=警示带
blueberry=蓝莓
pussy piercing=猫穿孔
ovum=卵子
title=标题
ribbon in mouth=丝带在嘴里
centaur=半人马座
truck=卡车
claw ring=爪环
rotational symmetry=旋转对称
side-tie leotard=侧系紧身连衣裤
blood from eyes=眼睛流血
holding needle=持针
grey necktie=灰色领带
kibito high school uniform=吉人高中制服
arm between breasts=手臂在乳房之间
used tissue=用过的纸巾
spiked shell=尖刺壳
palette (object)=调色板（对象）
puffy pants=蓬松的裤子
looking at animal=看着动物
bendy straw=弯曲的吸管
mascot=吉祥物
sakugawa school uniform=他们不分发校服
magnifying glass=放大镜
tiger boy=老虎男孩
truth=真相
holding shoes=拿着鞋子
overgrown=杂草丛生
thigh cutout=大腿镂空
sanshoku dango=三色饺子
yagasuri=箭头图案
viewer holding leash=观众拿着皮带
weibo logo=微博标志
twitching=抽搐
vibrator under panties=内裤下的振动器
buttjob=对接工作
arm wrap=手臂包裹
a certain high school uniform=某高中校服
garden=花园
drying=烘干
flame print=火焰印
bear girl=熊女孩
fangs out=尖牙出来
holding innertube=拿着内胎
plant girl=植物女孩
brown kimono=棕色和服
morning=早晨
cotton candy=棉花糖
hanging=绞刑
hand puppet=手偶
boned meat=带骨肉
hand on another's stomach=把手放在别人的肚子上
foot up=抬起脚
party hat=派对帽
alternate skin color=替代肤色
wiping tears=擦眼泪
fake facial hair=假胡子
striped kimono=条纹和服
halberd=戟
buzz cut=嗡嗡声
doughnut hair bun=甜甜圈发髻
spanking=打屁股
bowl cut=切碗
pixiv id=pixiv id
column=柱子
raimon=拉蒙
inflation=通货膨胀
playstation portable=便携式游戏机
heart tail=心尾
tight shirt=紧身衬衫
utility belt=实用腰带
penis out=阴茎出来
spirit=精神
spiked club=钉棒
invisible penis=看不见的阴茎
plaid headwear=格子头饰
leather belt=皮带
oral invitation=口头邀请
gym storeroom=健身房储藏室
lapels=翻领
glitch=毛刺
helicopter=直升机
sitting on object=坐在物体上
after ejaculation=射精后
kiyosumi school uniform=清澄校服
chest belt=胸带
okamisty=酸的
chocolate on body=身体上的巧克力
mole on neck=脖子上的痣
harem pants=哈伦裤
skyline=天际线
red-tinted eyewear=红色眼镜
open window=打开窗户
chef=厨师
mechanization=机械化
fake antlers=假鹿角
jersey=球衣
2013=2013
shirt in mouth=衬衫在嘴里
horns through headwear=穿过头饰的角
people=人们
untying=解开
pavement=路面
tree stump=树桩
handkerchief=手帕
idol clothes=偶像衣服
window shade=窗帘
timestamp=时间戳
pet play=宠物游戏
camcorder=摄像机
ass cutout=屁股镂空
halloween bucket=万圣节桶
dirndl=连衣裙
back-seamed legwear=后缝连裤袜
expressive hair=富有表现力的头发
baguette=法国面包
shiba inu=柴犬
constellation print=星座打印
molestation=骚扰
excessive pubic hair=过多的阴毛
neck=脖子
panty straps=裤带
holding handheld game console=拿着掌上游戏机
sitting on stairs=坐在楼梯上
redesign=重新设计
crane (machine)=起重机（机器）
stomach cutout=胃切口
holding leaf=拿着叶子
donation box=捐款箱
omurice=蛋包饭
2012=2012
black buruma=后灯笼裤
open pants=开裤
yellow wings=黄色的翅膀
orange thighhighs=橙色长筒袜
excessive cum=过度暨
2010=2010
stadium=体育场
holding helmet=拿着头盔
h&k hk416=h&k HK416
holding brush=拿着画笔
brushing teeth=刷牙
treasure chest=百宝箱
makizushi=卷寿司
hand on eyewear=手放在眼镜上
goat ears=山羊耳朵
gamepad=游戏手柄
index fingers together=食指并拢
panda ears=熊猫耳朵
triforce=三力
curtsey=瑟西
raised fist=举起拳头
oversized shirt=超大号衬衫
fur-trimmed skirt=皮草边饰半身裙
ruffling hair=乱糟糟的头发
brown necktie=棕色领带
eyewear on headwear=头饰上的眼镜
goblin=地精
ribbed bodysuit=罗纹连体衣
palm leaf=棕榈叶
pectoral grab=胸肌抓取
pointless condom=毫无意义的避孕套
kanji=汉子
\o/=\O/
pink sailor collar=粉色水手领
radio=收音机
micro panties=微内裤
bodice=紧身胸衣
stone lantern=石灯笼
sangvis ferri=用铁血
onmyouji=阴阳师
turtleneck dress=高领连衣裙
pom pom hair ornament=绒球发饰
coca-cola=可口可乐
globe=地球
blue fur=蓝色皮毛
blue headband=蓝色头带
monkey ears=猴耳
dangle earrings=吊坠耳环
carrying under arm=腋下携带
39=39
expressive clothes=富有表现力的衣服
lotion bottle=乳液瓶
pillbox hat=药盒帽
fertilization=施肥
spell card=符卡
cupping hands=拔罐手
red hood=红头罩
baseball mitt=我的棒球
male playboy bunny=男性花花公子兔子
purple one-piece swimsuit=紫色连体泳衣
takoyaki=章鱼烧
cow boy=牛仔
priest=牧师
orange sailor collar=橙色水手领
thrusters=推进器
dakimakura (object)=抱枕 (Obje CT)
countdown=倒数
electrokinesis=动电
spread pussy under clothes=把阴户撒在衣服下面
fiery hair=火热的头发
bear print=熊印
polka dot swimsuit=圆点泳衣
u.a. school uniform=美国校服
alternate weapon=备用武器
propeller=螺旋桨
happi=氧
prosthetic leg=假肢
venus symbol=金星符号
incoming attack=来袭
forehead-to-forehead=额头对额头
blonde pubic hair=金色的阴毛
ajirogasa=柳条帽
reflective water=反光水
tribal=部落的
shin guards=护胫
naked kimono=裸体和服
finger to face=手指面对面
u u=在你
twincest=双胞胎
plaid pants=格子裤
nanairogaoka middle school uniform=七彩丘中学制服
leg between thighs=大腿之间的腿
yes-no pillow=是-否枕头
screen=屏幕
tapir tail=貘尾巴
glomp=咕噜咕噜
impaled=刺穿
rainbow gradient=彩虹渐变
talking on phone=打电话
novel cover=小说封面
furry with furry=毛茸茸的
striped shorts=条纹短裤
short jumpsuit=连身短裤
overcoat=大衣
kettle=壶
sidepec=侧切
print bra=印花文胸
furrification=毛化
stone floor=石地板
cat teaser=逗猫棒
christmas lights=圣诞彩灯
intravenous drip=静脉滴注
no testicles=没有睾丸
grey bra=灰色文胸
debt=债务
blue eyeshadow=蓝色眼影
nike=耐克
crosswalk=人行横道
poker chip=筹码
2011=2011
masturbation through clothes=隔着衣服手淫
grey border=灰色边框
full-package futanari=Fuppa c 影子 futanari
sheet music=乐谱
wooden table=木桌子
incoming food=进来的食物
hauchiwa=你不被通缉
cloth gag=布塞
sweatpants=运动裤
black theme=黑色主题
chest strap=胸带
stab=刺
clock tower=钟楼
full-body tattoo=全身纹身
drawing bow=拉弓
potion=药水
carrying person=载人
italian flag=意大利国旗
school briefcase=学校公文包
brown-framed eyewear=棕框眼镜
pink bag=粉色包
leather gloves=皮手套
flip phone=翻盖手机
broken chain=断链
frilled socks=褶边袜
blowing kiss=飞吻
soccer=足球
mixing bowl=搅拌碗
log=日志
black pubic hair=黑色阴毛
kimono skirt=和服裙
slapping=拍打
snorkel=呼吸管
shoelaces=鞋带
humiliation=屈辱
lube=润滑油
mixed-language text=混合语言文本
orange slice=橙片
veiny breasts=静脉乳房
onee-loli=移沙
breathing fire=喷火
cheering=欢呼
lily of the valley=山谷里的百合
diving mask on head=头上的潜水面罩
camellia=茶花
origami=折纸
yes=是的
mandarin collar=马领
ribbed sleeves=罗纹袖
jaguar ears=美洲虎耳朵
frottage=擦
tropical drink=热带饮料
partially underwater shot=部分水下拍摄
imminent fellatio=即将发生的口交
pokedex number=图鉴编号
wooden fence=木围栏
multicolored bow=多彩多姿的弓
brown hairband=棕色发带
orange ascot=橙色领带
latex gloves=乳胶手套
stone wall=石墙
blue sash=蓝色腰带
diagonal-striped necktie=斜条纹领带
. .=. .
green flower=绿花
april fools=愚人节
bird on shoulder=肩上的鸟
sailor moon redraw challenge (meme)=美少女战士重绘挑战 (meme)
cup ramen=杯拉面
food-themed clothes=以食物为主题的衣服
playstation controller=游戏机控制器
tail grab=抓尾巴
red bandana=红头巾
mechanical tail=机械尾巴
severed head=断头
platform heels=厚底高跟鞋
plaid panties=格子内裤
jojo pose=乔乔姿势
cooperative paizuri=小歌剧院 paizuri
hands on feet=手放在脚上
cleaning=打扫
yellow hoodie=黄色连帽衫
single strap=单肩带
tail between legs=两腿之间的尾巴
bandaid on hand=创可贴在手
wrist guards=护腕
scooter=小型摩托车
pink collar=粉领
twitter logo=推特标志
cow=奶牛
grey kimono=灰色和服
sleeveless hoodie=无袖连帽衫
gloves removed=脱下手套
full-length zipper=全长拉链
head on another's shoulder=头靠在别人的肩膀上
dot mouth=点嘴
traditional clothes=传统服饰
lace-trimmed sleeves=蕾丝边袖
mole on ass=屁股上的痣
shower (place)=淋浴（地方）
bad perspective=坏观点
stove=火炉
unitard=联合会
shortstack=短筹码
torn panties=撕裂的内裤
ankle strap=踝带
two-sided cape=双面斗篷
stream=溪流
phonograph=留声机
x=X
steampunk=蒸汽朋克
slap mark=耳光标记
eyebrow piercing=眉毛穿孔
cat on head=猫在头上
respirator=呼吸器
yordle=约德尔
nippleless clothes=没有乳头的衣服
deer=鹿
hatsune miku (cosplay)=初音未来（角色扮演）
black male underwear=黑色男内裤
hamaya=入侵
tail wrap=尾巴包裹
hand net=手网
single pantsleg=单裤腿
pokemon on shoulder=肩膀上的口袋妖怪
sponge=海绵
purple tail=紫色的尾巴
yellow pupils=黄色瞳孔
animal ear legwear=动物耳朵裤袜
balancing=平衡
desk lamp=台灯
blue horns=蓝角
undone necktie=松开的领带
chainmail=链甲
hakama pants=还有裤子
purple capelet=紫色披肩
gold armor=黄金盔甲
clitoris piercing=阴蒂刺穿
bookmark=书签
werewolf=狼人
whispering=耳语
black leggings=黑色紧身裤
pants rolled up=裤子卷起来
boots removed=靴子被移除
emoji=恶魔及
mismatched pubic hair=不匹配的阴毛
bolo tie=是那些
cocktail dress=燕尾服
sidelighting=侧光
picnic basket=野餐篮子
fiery horns=火角
bad end=坏结局
multicolored shirt=五彩衬衫
eggplant=茄子
new school swimsuit=新学校泳装
tablecloth=桌布
on bench=在长凳上
shiny legwear=闪亮的裤袜
sobu high school uniform=总武高中制服
turning head=转头
green bodysuit=绿色连体衣
fake mustache=假胡子
power suit (metroid)=动力套装（银河系）
alphes (style)=阿尔法斯（风格）
mithra (ff11)=密特拉 (ff11)
skateboard=滑板
turtleneck leotard=高领紧身衣
orange neckerchief=橙色围巾
fireplace=壁炉
see-through skirt=透视裙
deerstalker=猎鹿人
sideways=侧身
cum on hands=暨在手上
breast conscious=乳房意识
polka dot legwear=圆点裤袜
dark penis=黑暗的阴茎
flustered=心慌
grey bikini=灰色比基尼
hand on own shoulder=手搭在自己的肩膀上
sunflower hair ornament=向日葵发饰
pink pupils=粉红色的瞳孔
ribbed leotard=罗纹紧身衣
kigurumi=kigurumi
club (shape)=俱乐部（形状）
tomoeda elementary school uniform=友枝小学生制服
real world location=真实世界位置
shinda sekai sensen uniform=死亡世界前线制服 rm
doctor=医生
german flag=德国国旗
no gloves=没有手套
stitched face=缝合脸
brown bikini=棕色比基尼
large testicles=大睾丸
greyscale with colored background=带彩色背景的灰度
aqua panties=水色内裤
pink coat=粉色外套
panties on head=头上的内裤
spoken character=口语
ryona=良奈
high kick=高踢腿
wheelchair=轮椅
blue collar=蓝领
lycoris uniform=制服酒
animal bag=动物袋
hat tip=小费
impossible swimsuit=不可能的泳装
pyrokinesis=运动
fake wings=假翅膀
lace-trimmed skirt=蕾丝边饰半身裙
stroking own chin=摸着自己的下巴
runes=符文
green sleeves=绿色袖子
sunscreen=防晒霜
stepped on=踩在
kimono pull=和服拉
kourindou tengu costume=香林堂天狗童爪
fingering through clothes=指法穿过衣服
curry rice=咖喱饭
tulip=郁金香
pie=在
skull mask=骷髅面具
soup=汤
paper airplane=纸飞机
wiping face=擦脸
lord camelot (fate)=卡洛特勋爵（命运）
kanabou=大麻
perpendicular paizuri=垂直 paizuri
puckered anus=肛门起皱
sex machine=性爱机器
teamwork=团队合作
friends=朋友们
duffel coat=粗呢大衣
bartender=调酒师
ammunition belt=弹药带
tent=帐篷
flashback=倒叙
cellphone picture=手机图片
age regression=年龄倒退
butterfly on hand=手上的蝴蝶
dust cloud=尘云
bath yukata=沐浴套装
single fingerless glove=单指手套
cheek bulge=脸颊隆起
animal hug=动物拥抱
sakuramon=樱门
sausage=香肠
molten rock=熔化的岩石
shinai=竹内
nearly naked apron=近乎裸体的围裙
sparkler=烟火
3d background=3d 背景
naked bandage=裸绷带
cum on penis=暨阴茎
short sidetail=短边细节
angel and devil=天使与魔鬼
large wings=大翅膀
odd one out=奇数
holding pillow=抱着枕头
ornate ring=华丽的戒指
burnt clothes=烧焦的衣服
2009=2009
bruise on face=脸上有瘀伤
asticassia school uniform=asticassia 校服
orange fur=橙色皮毛
papakha=爸爸
teruterubouzu=照照男孩
bat ears=蝙蝠耳朵
sick=生病的
open robe=开袍
pravda school uniform=真理报校服
athletic leotard=运动紧身连衣裤
harp=竖琴
black wristband=黑色腕带
tempura=天妇罗
hand on lap=手放在膝上
two-tone legwear=双色紧身裤
penis size difference=阴茎大小差异
striped sweater=条纹毛衣
lettuce=莴苣
giving up the ghost=放弃幽灵
ankh=安赫
holographic interface=全息界面
winged footwear=翼鞋
split screen=分屏
opening door=开门
arm blade=臂刃
acrylic paint (medium)=丙烯颜料（中）
suspended congress=暂停国会
hawaiian shirt=夏威夷衬衫
leg armor=护腿
fur-trimmed cloak=毛皮边斗篷
asymmetrical horns=不对称喇叭
crate=箱
milking machine=挤奶机
wig=假发
bow earrings=蝴蝶结耳环
anilingus=安宁
eye of horus=荷鲁斯之眼
gathers=聚集
ladybug=瓢虫
laser=激光
tiered tray=分层托盘
wading pool=浅水池
uvula=小舌
watermelon bar=西瓜吧
hands on another's cheeks=把手放在另一个人的脸颊上
yellow bodysuit=黄色连体衣
sandals removed=凉鞋脱掉
inset=插图
excalibur morgan (fate)=神剑摩根（命运）
ema=母亲
behind another=在另一个后面
ferris wheel=摩天轮
lizard tail=蜥蜴尾巴
gym=健身房
machine=机器
fountain=喷泉
cum on self=射在自己身上
torn scarf=撕破的围巾
pasta=意大利面
voyeurism=窥淫癖
artificial eye=人工眼
hair ears=头发耳朵
candy hair ornament=糖果发饰
bird mask=鸟面具
on vehicle=在车辆上
living clothes=生活服
grey ribbon=灰丝带
through wall=穿墙
aqua headwear=水绿色头饰
chest of drawers=五斗柜
open belt=开带
leopard tail=豹尾巴
kamiyama high school uniform (hyouka)=作者：Kamiyama Gh s O l Unifor rm（评估）
park=公园
ballerina=芭蕾舞女演员
ketchup=番茄酱
ginkgo leaf=银器 f
snail=蜗牛
neckwear grab=领带抢
iphone=iPhone
potato=土豆
brown panties=棕色内裤
newhalf=新半
overcast=灰蒙蒙
year of the rat=鼠年
champion uniform=冠军制服
leather boots=皮靴
heartbeat=心跳
disgust=厌恶
cropped shoulders=七分肩
eyebrow cut=剪眉
load bearing vest=承重背心
rook (chess)=车（国际象棋）
cheek squash=西葫芦
belt boots=腰带靴
hooded cardigan=连帽开衫
lace-trimmed gloves=蕾丝边手套
native american=美洲原住民
red eyeliner=红色眼线
tengu=天狗
orange-tinted eyewear=橙色眼镜
breast expansion=丰胸
hitting=打
hands on ass=手放在屁股上
blue armor=蓝色盔甲
gift bag=礼品袋
striped horns=条纹牛角
orange panties=橙色内裤
honeycomb (pattern)=蜂窝（图案）
konohagakure symbol=木叶符号
plate armor=板甲
white serafuku=怀特
riding pokemon=骑乘宠物小精灵
art brush=艺术画笔
utensil in mouth=嘴里的器具
hickey=吻痕
crystal hair=水晶发
mismatched sleeves=不匹配的袖子
two-tone hairband=双色发带
knees apart feet together=双膝分开双脚并拢
steering wheel=方向盘
bus stop=公交车站
gradient clothes=渐变衣服
torn jeans=破牛仔裤
kesa=比
chalk=粉笔
dark aura=黑暗光环
bow (music)=鞠躬（音乐）
orange pantyhose=橙色连裤袜
wrestling ring=摔跤场
vibrator in thighhighs=长筒袜中的振动器
dark green hair=深绿色的头发
flashlight=手电筒
pink pantyhose=粉色连裤袜
futa on male=futa 上 男性
hooded track jacket=连帽运动夹克
brown cloak=棕色斗篷
they had lots of sex afterwards (meme)=他们之后有很多性行为（模因）
flower necklace=花项链
battle axe=战斧
alpaca ears=羊驼耳朵
lalafell=啦啦啦
purple belt=紫带
grey sleeves=灰色袖子
laundry=洗衣店
guiding hand=指导手
shards=碎片
collared coat=有领大衣
digitigrade=数字化
holding balloon=拿着气球
bikesuit=机车服
torpedo launcher=鱼雷发射器
theft=盗窃
battle rifle=战斗步枪
low neckline=低领口
island=岛
eyewear strap=眼镜带
phoenix crown=凤冠
cum on feet=暨在脚上
oven mitts=烤箱手套
bishop (chess)=主教（国际象棋）
off-shoulder bikini=露肩比基尼
ready to draw=准备画画
unicorn=独角兽
user interface=用户界面
holding game controller=拿着游戏控制器
soda bottle=汽水瓶
chimney=烟囱
ipod=ipod
uchikake=发射
silver trim=银色饰边
gradient legwear=渐变裤装
mechanical ears=机械耳朵
holding water gun=拿着水枪
guitar case=吉他盒
petals on liquid=液体上的花瓣
ruler=统治者
round window=圆窗
buruma pull=布鲁玛拉
back focus=后焦点
cactus=仙人掌
implied yuri=隐含的尤里
ballet slippers=芭蕾舞鞋
horse penis=马阴茎
fuuin no tsue=封印魔杖
archery=射箭
pinching sleeves=捏袖子
triangle print=三角印
blue sclera=蓝色巩膜
toilet use=厕所使用
bow choker=蝴蝶结项圈
mechanical hands=机械手
french text=法语文本
motherly=母爱
kitchen knife=菜刀
shirt grab=衬衫抢
dice hair ornament=骰子发饰
ootachi=大立
drum set=鼓组
dumbbell=哑铃
brown socks=棕色袜子
title parody=标题戏仿
blue tongue=蓝舌头
grimoire=魔法书
vaulting horse=跳马
single hair ring=单发圈
light censor=光传感器
mask around neck=脖子上的面具
lighter=打火机
legs over head=双腿举过头顶
champagne=香槟酒
bad food=不好的食物
red oni=命令他们
pouty lips=噘嘴
adjusting legwear=调整裤袜
shared bathing=共用浴室
fishnet top=渔网顶
ribbon-trimmed dress=缎带边饰连衣裙
coffin=棺材
3others=3其他
anchor print=锚印
reindeer=驯鹿
sleeveless turtleneck leotard=无袖高领紧身衣
soap censor=肥皂审查员
flock=群
climbing=攀登
upshorts=短裤
luggage=行李
cat day=猫日
sundae=圣代
split ponytail=分裂马尾辫
cum in clothes=暨在衣服里
satin=缎
queen (chess)=皇后（国际象棋）
fake cover=假封面
hooded robe=连帽长袍
compass rose halo=罗盘玫瑰光环
fish print=鱼纹
heart-shaped lock=心形锁
mouth pull=嘴拉
pink socks=粉色袜子
legs folded=双腿折叠
drum (container)=鼓（容器）
torn leotard=撕裂的紧身连衣裤
liquid hair=液体头发
comparison=比较
heart button=心形按钮
cooler=冷却器
consensual tentacles=双方同意的触角
ammunition=弹药
ass support=屁股支持
pennant=锦旗
body freckles=身体雀斑
salaryman=来吧，伙计
honey=蜂蜜
weight conscious=体重意识
spoken object=口语对象
photo inset=照片插图
striped one-piece swimsuit=条纹连体泳衣
pink wings=粉红色的翅膀
drawing sword=拔剑
yellow apron=黄色围裙
puppet strings=木偶弦
multiple monochrome=多重单色
shell bikini=贝壳比基尼
decepticon=霸天虎
anal hair=肛毛
looking at mirror=看着镜子
butterfly net=捕蝶网
boar=公猪
looking at breasts=看着乳房
strap lift=吊带
cheek press=面颊按压
6+others=6+其他
stuffed winged unicorn=毛绒独角兽
no lineart=没有线稿
head on pillow=头靠在枕头上
washing=洗涤
test plugsuit=测试插件
abuse=虐待
keizoku military uniform=继续
tanzaku=丹作
rising sun flag=朝阳旗
wall of text=文字墙
brown bowtie=棕色领结
blue cloak=蓝色斗篷
arrow through heart=箭穿心
holding baseball bat=拿着棒球棒
patterned=有图案的
plaid jacket=格子夹克
cum on pussy=暨猫
glowing wings=发光的翅膀
party popper=礼花
grey belt=灰带
after rape=强奸后
chocolate on breasts=乳房上的巧克力
candy wrapper=糖果纸
bow legwear=蝴蝶结裤
phallic symbol=阴茎符号
blue overalls=蓝色工作服
master sword=大师剑
button eyes=纽扣眼
purple fire=紫火
covering ass=遮屁股
bicorne=双角
round image=圆形图像
c:=C：
screwdriver=螺丝刀
swim cap=泳帽
combat boots=作战靴
clothes=衣服
torn swimsuit=撕裂的泳衣
fishnet gloves=渔网手套
bus=公共汽车
dropping=掉落
wrinkled skin=皱纹的皮肤
birthmark=胎记
loose bowtie=宽松的领结
jimiko=清醒的孩子
strawberry hair ornament=草莓发饰
clog sandals=木屐凉鞋
saunders military uniform=桑德斯军装
duster=除尘器
cutting board=砧板
forked tongue=分叉的舌头
mole above mouth=嘴巴上方的痣
uncommon stimulation=不寻常的刺激
red bag=红包
k/da (league of legends)=k/da（英雄联盟）
tearing clothes=撕衣服
picnic=野餐
hairjob=她的工作
hanetsuki=有羽毛的
white tail=白尾巴
denim jacket=牛仔外套
sword behind back=背后的剑
borrowed design=借来的设计
aestus estus=你会很热
grocery bag=购物袋
mechanical eye=机械眼
spreader bar=撑杆
comforting=安慰
detective=侦探
fume=烟
bunny-shaped pupils=兔形瞳孔
weighing scale=体重秤
tennis ball=网球
yellow sash=黄色腰带
holding own tail=夹着自己的尾巴
holding scissors=拿着剪刀
licking another's face=舔别人的脸
onbashira=御柱
ashford academy school uniform=阿什福德学院校服
red apron=红围裙
santa gloves=圣诞老人手套
single horizontal stripe=单横条纹
tricorne=三角角
imminent anal=迫在眉睫的肛门
doily=桌布
back-print panties=背面印花内裤
galaxy expedition team survey corps uniform=银河远征队调查兵团制服
head down=低头
cross print=交叉打印
camouflage jacket=迷彩夹克
grey neckerchief=灰色围巾
pill earrings=药丸耳环
holding jacket=拿着夹克
morning glory=喇叭花
pearl bracelet=珍珠手链
sharp toenails=尖锐的脚趾甲
thai text=泰文
loungewear=家居服
elezen=在语言中
stealth sex=秘密性行为
nata (tool)=nata（工具）
guided breast grab=引导乳房抓取
vampire costume=吸血鬼服装
shoulder strap=肩带
scarf over mouth=嘴上围巾
bulletproof vest=防弹背心
angora rabbit=安哥拉兔
wakizashi=胁差
holding legs=抱腿
aria company uniform=阿里亚公司制服
campfire=营火
soda=苏打
beans=豆子
pink hakama=也是粉红色的
squidbeak splatoon=乌贼喙排
upshirt=上衣
pink capelet=粉色披肩
grey nails=灰指甲
yarn=纱
telescope=望远镜
tooth necklace=牙齿项链
vertical-striped pantyhose=竖条纹连裤袜
training bra=训练文胸
accidental exposure=意外暴露
summer festival=夏祭
necktie grab=领带抢
yin yang orb=阴阳orb
smokestack hair ornament=烟囱发饰
snack=小吃
motorcycle helmet=摩托车头盔
"don't say ""lazy"""=“别说‘懒惰’”
canvas (object)=画布（对象）
dildo riding=假阳具骑
prehensile tail=抓握的尾巴
hand to head=手对头
headless=无头
tassel hair ornament=流苏发饰
off-shoulder jacket=露肩夹克
hospital bed=病床
heart balloon=心形气球
asa no ha (pattern)=句柄没有（图案）
holding stylus=手写笔
lute (instrument)=琵琶（乐器）
extra mouth=额外的嘴
goat girl=山羊女孩
multicolored fur=五彩毛皮
bored=无聊的
pointy footwear=尖头鞋
brown leotard=棕色紧身衣
clapping=鼓掌
walkie-talkie=对讲机
hand on forehead=手放在额头上
paw print background=爪印背景
2000s (style)=2000年代（风格）
basketball uniform=篮球服
black corset=黑色紧身胸衣
star of david=大卫之星
survey corps (emblem)=调查兵团（徽章）
pendant choker=在扼流圈期间
under kotatsu=幸运的被炉
thermometer=温度计
wetsuit=潜水服
multiple braids=多条辫子
hot dog=热狗
trash bag=垃圾袋
shuujin academy school uniform=修真学院校服
vore=是
pilot=飞行员
messenger bag=斜挎包
spit take=吐带
oohashi high school uniform=大桥高中制服
poke ball theme=精灵球主题
frog print=青蛙印花
egg hair ornament=鸡蛋发饰
sand sculpture=沙雕
erect clitoris=勃起的阴蒂
torn gloves=破手套
sig sauer=酸的
belly grab=肚皮抓
radiation symbol=辐射符号
snake hair=蛇毛
shorts under dress=连衣裙下的短裤
hand on another's waist=把手放在别人的腰上
heart o-ring=心形O形圈
backless leotard=露背紧身连衣裤
fur-trimmed kimono=毛皮边饰和服
poster (medium)=海报（中）
cum on legs=暨在腿上
ugly man=丑男人
ice skates=冰刀
outstretched leg=伸出的腿
crocodilian tail=鳄鱼尾巴
breast focus=乳房焦点
multiple straps=多个肩带
yellow pants=黄色裤子
diaper=尿布
tail piercing=尾巴穿孔
pink pajamas=创收
chat log=聊天记录
applying makeup=化妆
kaijuu=开局U
print headwear=印花头饰
key necklace=钥匙项链
cocktail=鸡尾酒
cowboy boots=牛仔靴
colored shadow=彩色影子
multicolored cape=五彩斗篷
nintendo ds=任天堂 ds
yellow leotard=黄色紧身衣
socks removed=袜子脱掉
berry=浆果
hydrokinesis=液体运动
noh mask=能面具
tantou=探头
tonfa=通发
covering one eye=遮住一只眼睛
purple eyeshadow=紫色眼影
human scabbard=人刀鞘
easel=画架
triangle earrings=三角耳环
bandaged neck=绷带的脖子
hair flip=头发翻转
frilled shorts=荷叶边短裤
broken weapon=破损的武器
furigana=折假名
multiple piercings=多个穿孔
voice actor=配音演员
crayon=蜡笔
st. gloriana's (emblem)=英石。 gloriana 的（徽章）
thighhighs over pantyhose=长筒袜超过连裤袜
player 2=玩家 2
panzerkampfwagen iv=四号坦克
reins=缰绳
ninja mask=忍者面具
instagram username=用户名
corn=玉米
screw=拧紧
naked overalls=裸体工作服
zabuton=扎布顿
tools=工具
torn jacket=破夹克
duel academy uniform (yu-gi-oh! gx)=决斗学院制服 (Yu-Gi-Oh! GX)
red apple=红苹果
glowing horns=发光的角
musou isshin (genshin impact)=无双更新（Genshin Impacter CT）
vanishing point=消失点
rectangular mouth=长方形嘴
in cup=在杯子里
tentacles under clothes=衣服下的触手
orange pants=橙色裤子
psychic=精神
toilet paper=卫生纸
folding chair=折叠椅
good end=好结局
war=战争
green hakama=绿色也是
penises touching=阴茎接触
traditional chinese text=繁体中文
daruma doll=达摩娃娃
brown sweater vest=棕色毛衣背心
calico=印花布
lactation through clothes=透过衣服哺乳
snowball=滚雪球
wood=木头
eden academy school uniform=伊甸学园校服
overall shorts=整体短裤
thread=线
chewing=咀嚼
blank stare=两眼发直
bc freedom military uniform=BC自由军装
hand on another's leg=把手放在别人的腿上
corded phone=有线电话
drinking straw in mouth=嘴里含吸管
hanten (clothes)=hanten（衣服）
facing to the side=面对侧面
toast in mouth=嘴里吐司
wiping sweat=擦汗
huge bow=巨大的弓
from outside=从外面
saiyan armor=赛亚人盔甲
hands on own ass=手放在自己的屁股上
drying hair=吹干头发
hoop=箍
pornography=色情
facepalm=捂脸
no tail=没有尾巴
tiger stripes=老虎条纹
king (chess)=国王（国际象棋）
pet bowl=宠物碗
purple gemstone=紫色宝石
dark areolae=深色乳晕
cd=光盘
troll face=巨魔的脸
square 4koma=方形 4koma
transparent wings=透明的翅膀
scar on stomach=肚子上的伤疤
white snake=白蛇
pursed lips=噘起嘴唇
holding fishing rod=拿着鱼竿
purple scrunchie=紫色发带
dudou=肚兜
yellow bag=黄色袋子
anzio military uniform=安齐奥军服
pier=码头
animal on lap=膝上的动物
>o<=>o<
shopping=购物
ink tank (splatoon)=墨盒（splatoon）
sailor senshi=水手战士
under tree=树下
sleeve garter=袖吊袜带
fur-trimmed shorts=毛边短裤
adapted turret=改装炮塔
coin hair ornament=硬币发饰
ear biting=咬耳朵
eyewear hang=眼镜挂
telstar=电讯之星
double vertical stripe=双竖条纹
palms together=双手合十
white tiger=白老虎
manga cover=漫画封面
streamers=飘带
dotted line=虚线
cat ear legwear=猫耳裤
vibrator cord=振动器线
rocket=火箭
rice on face=米饭在脸上
hat over one eye=帽子盖住一只眼睛
blind=瞎的
bird legs=鸟腿
multicolored horns=五彩角
industrial piercing=工业穿孔
barbed wire=铁丝网
alice (alice in wonderland) (cosplay)=爱丽丝（爱丽丝梦游仙境）（角色扮演）
popcorn=爆米花
frogtie=青蛙领带
ballet=芭蕾舞
slashing=削减
team rocket uniform=火箭队制服
cropped hoodie=短款连帽衫
looking outside=看外面
cum on pectorals=射在胸肌上
bubble tea challenge=泡茶挑战
griffin & kryuger military uniform=格里芬和克鲁格军装
boxer briefs=平角内裤
grey theme=灰色主题
footwear ribbon=鞋带
kine=牛
pencil case=铅笔盒
brown wings=棕色的翅膀
white bag=白色袋子
kissing hand=亲吻手
telekinesis=心灵感应
open bodysuit=开放式紧身连衣裤
floating island=浮岛
blank censor=空白审查员
print jacket=印花夹克
shark costume=鲨鱼服装
flying kick=飞踢
sparse pubic hair=稀疏的阴毛
green capelet=绿色披肩
yellow coat=黄色外套
wet dress=湿衣服
tentacle pit=触手坑
virgin killer outfit=处女杀手装
character censor=性格审查员
bandolier=子弹带
frilled ascot=褶边领巾
drugs=药物
wrist wrap=腕带
scar on neck=脖子上的伤疤
single boot=单启动
catholic=天主教的
kepi=戳
swimsuit cover-up=泳衣遮盖
red border=红色边框
texture=质地
pastel colors=柔和的颜色
keystone=基石
naked scarf=裸围巾
bokken=山羊
holding vegetable=拿着蔬菜
raimon soccer uniform=雷蒙足球服
spooning=勺子
unzipping=解压缩
white umbrella=白伞
star brooch=星星胸针
flower ornament=花饰
purple-framed eyewear=紫框眼镜
saber (weapon)=军刀（武器）
portrait (object)=肖像（物体）
skirt basket=裙篮
single stripe=单条纹
lowleg pants=低腿裤
polka dot headwear=圆点头饰
fleur de lapin uniform=兔子花制服
boobplate=胸板
dandelion=蒲公英
multiple swords=多把剑
blood on knife=刀上的血
glaive (polearm)=大刀（长柄）
hanbok=韩服
yellow butterfly=黄蝴蝶
pointy breasts=尖尖的乳房
noose=套索
aquarium=水族馆
multiple riders=多个骑手
brick=砖
voile=帆
triple penetration=三重渗透
brown apron=棕色围裙
rabbit boy=兔子男孩
rainbow hair=彩虹头发
sidewalk=人行道
mash kyrielight (dangerous beast) (cosplay)=mash kyrielight（危险的野兽）（角色扮演）
diamond (gemstone)=钻石（宝石）
flaming weapon=燃烧的武器
nanodesu (phrase)=就是这样（ph种族）
otter ears=水獭耳朵
stain=弄脏
crystal earrings=水晶耳环
red fur=红色皮毛
brown hoodie=棕色连帽衫
child drawing=儿童画
cleaver=菜刀
akanbe=阿寒部
backpack removed=背包被移除
team 9=9队
analog clock=模拟时钟
space helmet=太空头盔
sleeveless coat=无袖外套
no eyebrows=没有眉毛
yellow belt=黄带
ar-15=with-15
pushing=推动
yarn ball=纱球
fur cape=毛皮斗篷
icing=刨冰
foam=泡沫
vertical-striped bikini=竖条纹比基尼
haniwa (statue)=埴轮
peace symbol=和平符号
hourglass=滴漏
baggy clothes=松松垮垮的衣服
undressing another=脱衣服另一个
barefoot sandals=赤脚凉鞋
notched ear=缺口耳朵
dvd cover=DVD封面
falchion (fire emblem)=猎刀（火焰纹章）
porch=门廊
houndstooth=千鸟格
japari bun=好日本
puffy cheeks=浮肿的脸颊
lace-trimmed hairband=蕾丝边饰发带
amulet=护身符
brown collar=棕领
bayonet=刺刀
owl ears=猫头鹰耳朵
bamboo steamer=竹蒸笼
papers=文件
hand on leg=手放在腿上
camouflage pants=迷彩裤
bandaid on forehead=额头上的创可贴
dress flower=礼服花
bilingual=双语
henshin=恒信
two-tone headwear=双色头饰
studded bracelet=镶嵌手链
black garter belt=黑色吊袜带
blue bag=蓝色包
mummy costume=木乃伊装
tokisadame school uniform=Tokisadam的校服
print shorts=印花短裤
heel up=非常向上
searchlight=探照灯
between pectorals=胸肌之间
holding pizza=拿着披萨
kouhaku nawa=红白绳
aviator sunglasses=飞行员太阳镜
snap-fit buckle=搭扣
striped hoodie=条纹连帽衫
green bag=绿色袋子
loose shirt=宽松衬衫
polka dot skirt=圆点裙
purple hakama=也是紫色的
smoking gun=确凿的证据
crotch cutout=胯部镂空
cetacean tail=鲸鱼的尾巴
orange sweater=橙色毛衣
crystal ball=水晶球
convenience store=便利店
seaweed=海藻
guided penetration=引导渗透
ankle wrap=脚踝包裹
anglerfish=琵琶鱼
inverted cross=倒十字
concert=音乐会
nursing handjob=护理打手枪
linear hatching=线性孵化
playing=玩
saddle=鞍
dress removed=裙子脱了
washing machine=洗衣机
valkyrie=女武神
striped headwear=条纹头饰
antique firearm=古董枪支
jaguar print=美洲豹印花
visor (armor)=遮阳板（盔甲）
strawberry panties=草莓内裤
checkered flag=方格旗
ears visible through hair=透过头发可以看到耳朵
strapless swimsuit=露肩泳装
objectification=客体化
audience=观众
head chain=头链
hand on another's neck=把手放在别人的脖子上
breastfeeding=哺乳
pink camisole=粉色吊带背心
clothes between breasts=乳房之间的衣服
green wings=绿色的翅膀
pinwheel=风车
cursive=草书
double w=双w
hand on own neck=手放在自己的脖子上
blowing=吹
penguin hood=企鹅罩
monster energy=怪兽能量
coconut=椰子
side drill=边钻
<o> <o>=<o> <o>
sperm cell=精细胞
cute & girly (idolmaster)=可爱又少女（偶像大师）
elvaan=活过来
waiter=服务员
prison clothes=囚衣
fur boots=毛皮靴
sleep mask=睡眠面膜
oda uri=房间uri
public use=公用
adidas=阿迪达斯
gold bikini=金色比基尼
coke-bottle glasses=可乐瓶眼镜
pickaxe=鹤嘴锄
painterly=绘画般的
cutting hair=剪头发
traffic cone=交通拥挤
heads-up display=平视显示器
themed object=主题对象
side slit shorts=侧开衩短裤
pouring onto self=倾注于自我
m1911=m1911
food stand=小吃摊;路边摊
hands on own stomach=双手放在自己的肚子上
lion boy=狮子男孩
airship=飞艇
tail feathers=尾羽
bullet hole=子弹孔
bass clef=只是成本
round-bottom flask=圆底烧瓶
double dildo=双假阳具
lace gloves=蕾丝手套
undead=亡灵
hologram=全息图
brown nails=棕色指甲
napkin=餐巾
broken heart=破碎的心
ultra ball=超级球
recorder=录音机
united states=美国
yellow sleeves=黄色袖子
x3=零
cross choker=交叉项圈
cropped arms=裁剪的手臂
tail ring=尾环
hole=洞
polka dot scrunchie=圆点发圈
rider belt=骑行带
pine tree=松树
pink belt=粉色腰带
araki hirohiko (style)=动态风格
multicolored kimono=五彩和服
mole on stomach=肚子上的痣
plaid bra=格子好
hishaku=钢包
crazy=疯狂的
unamused=不开心的
checkered sash=方格腰带
purple hoodie=紫色连帽衫
oversized food=超大食物
mahjong tile=麻将牌
holding saucer=托碟
jeweled branch of hourai=宝来宝枝
black umbrella=黑伞
exhausted=筋疲力尽的
sling=吊带
screentones=网点
white sports bra=白色运动文胸
ghost costume=幽灵装
tube dress=抹胸连衣裙
parka=派克大衣
dirty feet=脏脚
wringing clothes=拧干衣服
scar on leg=腿上的伤疤
gills=鳃
melon bread=甜瓜面包
bear costume=熊装
lighthouse=灯塔
puff and slash sleeves=泡泡袖
tentacles on male=雄性触手
unusually open eyes=异常睁眼
multiple moles=多颗痣
kimono lift=和服电梯
glowing butterfly=发光的蝴蝶
cum in nose=射在鼻子里
\n/=\n/
apron lift=停机坪升降机
cardigan vest=开衫背心
looking through legs=透过腿看
double \m/=双 \m/
sparrow=麻雀
art nouveau=新艺术风格
pink ascot=粉红色领带
net=网
romper=休息
easter egg=复活节彩蛋
st. chronica academy school uniform=英石。编年史学院校服
tracen training uniform=Tracen训练服
arms around waist=搂着腰
wall clock=挂钟
wa lolita=洛丽塔的
crime prevention buzzer=预防犯罪蜂鸣器
star pasties=明星馅饼
acoustic guitar=原声吉他
tokyo-3 middle school uniform=东京第三中学制服
adapted uniform=适应制服
grave=坟
orange hoodie=橙色连帽衫
arachne=蛛形纲
green pantyhose=绿色连裤袜
p90=p90
object through head=物体通过头部
hat with ears=有耳朵的帽子
brown bra=棕色文胸
leash pull=皮带拉
black undershirt=黑色汗衫
bralines=bralines
squinting=眯眼
storefront=店面
panty lift=内裤提升
cracked wall=开裂的墙
golf club=高尔夫俱乐部
futasub=双潜
white butterfly=白蝴蝶
buster sword=克星剑
anchor necklace=锚项链
lyrics=lyrics
foliage=叶子
wheelbarrow=独轮车
gradient dress=渐变连衣裙
wataboushi=棉帽
chalice=圣杯
shoulder holster=肩套
grey hairband=灰色发带
glowing hair=发光的头发
grey cape=灰色斗篷
stained panties=染色内裤
grill=炙烤
hand under shirt=手在衬衫下
purple neckerchief=紫色围巾
curtained hair=垂帘的头发
animal ear headwear=兽耳头饰
nudist=裸体主义者
penis peek=阴茎偷看
breast poke=戳胸
dragging=拖动
baton (conducting)=指挥棒（指挥）
tall=高的
ojou-sama pose=姿势小姐
aqua gloves=水族手套
masochism=受虐狂
struggling=挣扎
rolling suitcase=拉杆箱
animal skull=动物头骨
tutu=寒冷的
tsab ground military uniform=tsab地面军装
holding breath=屏住呼吸
tire=胎
satin panties=缎面内裤
hooded bodysuit=连帽连体衣
vibrator on nipple=乳头上的振动器
breast padding=胸垫
armpit cutout=腋下镂空
multi-strapped panties=多带内裤
amplifier=放大器
kotoyoro=琴代郎
string bra=串好
heart lock (kantai collection)=心锁（舰队合集）
skirt flip=裙摆
season connection=季节联系
spiked choker=尖刺项圈
thermos=热水瓶
spaghetti=意大利细面条
snowflake background=雪花背景
group picture=集体照
multiple legs=多条腿
windowsill=窗台
shoulder cannon=肩炮
pravda military uniform=真理报军装
chi-hatan military uniform=赤哈坦军装
urethral insertion=尿道插入
excited=兴奋的
polar bear=北极熊
bean bag chair=豆袋椅
hand gesture=手势
training corps (emblem)=训练团（会徽）
yuigaoka school uniform=由丘校服
gymnastics=体操
naked tabard=裸体战袍
holding ribbon=拿着丝带
energy drink=能量饮料
wallet=钱包
evangelion (mecha)=新世纪福音战士（机甲）
witch (madoka magica)=女巫 (madoka magica)
yurigaoka girls academy school uniform=百合之丘女子学院校服
dressing another=穿另一个
alternate wings=交替的翅膀
crescent print=月牙印
color trace=色迹
multicolored scarf=五彩围巾
aqua jacket=水绿色夹克
stole=偷
fake nails=假指甲
penis in panties=内裤里的阴茎
kikumon=菊花冠
hair flowing over=头发流过
coat removed=脱掉外套
flaming sword=火焰剑
lattice=格子
canopy bed=天蓬床
group name=团队名字
bunny hat=兔子帽
pigeon=鸽子
aqua footwear=水上运动鞋
bar stool=酒吧椅子
catchphrase=口号
multicolored headwear=五彩头饰
grey capelet=灰色披肩
pectoral press=胸部按压
in water=在水里
collared vest=有领背心
jaguar tail=美洲豹尾巴
trigram=trigram
astronaut=宇航员
riyo (lyomsnpmp) (style)=riyo（lyomsnpmp）（风格）
hanasakigawa school uniform=作者：花崎川 Or Unifor rm
circle skirt=圆裙
grey bodysuit=灰色连体衣
brick floor=砖地板
yellow raincoat=黄色的雨衣
grenade launcher=榴弹发射器
cat costume=猫装
latex legwear=乳胶裤袜
yo-yo=悠悠球
leg wrap=裹腿
electrical outlet=电源插座
bath stool=浴凳
multicolored footwear=多彩多姿的鞋子
dumpling=饺子
anchor choker=锚项链
blank speech bubble=空白对话泡泡
brown choker=棕色项圈
beam saber=光束军刀
arm above head=手臂举过头顶
shorts around one leg=一条腿周围的短裤
wheat=小麦
onion=洋葱
rounded corners=圆角
colored nipples=彩色乳头
spray can=喷雾罐
double fox shadow puppet=双狐皮影
sitting on rock=坐在岩石上
paper crane=千纸鹤
eyepatch removed=取下眼罩
pink fur=粉红色的皮毛
sparkle print=闪光印花
heart collar=心领
karaoke=卡拉OK
ganguro=黑猩猩
floating scarf=漂浮的围巾
no blindfold=没有眼罩
bunching hair=束发
nipple clamps=乳头夹
maneki-neko=招财猫
surcoat=外套
imperial japanese army=日本帝国陆军
cutout above navel=肚脐上方镂空
taimanin suit=台湾人水 t
nejiri hachimaki=扭头带
yellow cape=黄色斗篷
chicken (food)=鸡（食物）
snow bunny=雪兔
condom belt=避孕套带
german flag bikini=德国国旗比基尼
inline skates=直排轮滑鞋
tape measure=卷尺
bib=围兜
hands on hilt=把手放在刀柄上
green tea=绿茶
pendant watch=挂表
sand castle=沙堡
no mole=不酷
hammock=吊床
handstand=手倒立
ammunition pouch=弹药袋
cartoon bone=卡通骨头
boy sandwich=男孩三明治
okobo=奥科博
arm cuffs=袖口
seat=座位
upturned eyes=上翘的眼睛
st. theresa's girls academy school uniform=英石。德丽莎女子学院校服
fur cloak=毛皮斗篷
teacher and student=师生
character signature=字符签名
no eyepatch=没有眼罩
super soaker=超级浸泡
holding ladle=拿着钢包
orange sleeves=橙色袖子
inflatable raft=充气筏
chinese new year=中国新年
kinchaku=钱包
finger biting=咬手指
cursor=光标
hands on another's hips=双手放在别人的臀部
pokemon move=宠物小精灵移动
lightsaber=光剑
orange skin=橙皮
windmill=风车
ribbon braid=丝带编织
sideways hat=侧身帽子
thick lips=厚嘴唇
ehoumaki=ehoumaki
star tattoo=明星纹身
single ear cover=单耳套
green one-piece swimsuit=绿色连体泳衣
multiple heads=多头
blood in hair=头发里有血
pink border=粉色边框
holding bucket=拿着桶
dog penis=狗阴茎
dialogue box=对话框
vertical-striped panties=竖条纹内裤
oversized limbs=超大的四肢
nib pen (object)=尖笔（物体）
jacket pull=夹克拉
white armor=白色盔甲
2008=2008
bagged fish=袋装鱼
honeycomb background=蜂窝背景
frozen=冻结的
dissolving=溶解
star guardian (league of legends)=星之守护者（英雄联盟）
ball and chain restraint=球链约束
flag background=国旗背景
eldritch abomination=可怕的憎恶
hololive idol uniform=hololive偶像制服
licking armpit=舔腋下
orange leotard=橙色紧身衣
print necktie=印花领带
beltskirt=腰带裙
ornament=装饰品
breast cutout=胸部镂空
pink cape=粉色斗篷
neck tassel=颈流苏
swinging=摆动
mundane utility=平凡的效用
frilled leotard=褶边紧身连衣裤
pizza slice=披萨片儿
elbows on table=桌子上的手肘
weightlifting=举重
toe ring=趾环
nipple bar=乳头棒
kousaka kirino's school uniform=身高或剪裁由 l Unifor rm 编写
orange goggles=橙色护目镜
elephant=大象
bicycle basket=自行车篮
kappa=河童
boxcutter=裁箱机
personality switch=性格转换
misunderstanding=误解
clothes between thighs=大腿之间的衣服
pointy nose=尖鼻子
x-shaped pupils=x型瞳孔
two-handed handjob=双手打手枪
melon=瓜
ass-to-ass=屁股对屁股
pinstripe shirt=细条纹衬衫
card parody=卡模仿
cephalopod eyes=头足类动物的眼睛
two-tone bow=双音弓
joy-con=游戏机
mummy=木乃伊
cartridge=墨盒
blue border=蓝色边框
bullying=欺凌
sneezing=打喷嚏
stats=统计数据
holding envelope=拿着信封
kabuto (helmet)=kabuto（头盔）
animal on arm=手臂上的动物
pet=宠物
tented shirt=帐篷衬衫
clothes tug=衣服拖船
tongs=钳
mole on cheek=脸颊上的痣
legband=腿带
note=笔记
flower tattoo=花纹身
flower bracelet=花手链
super saiyan 1=超级赛亚人1
speaking tube headset=话筒耳机
tail hug=尾抱
mismatched eyebrows=不匹配的眉毛
multiple drawing challenge=多图挑战
purple horns=紫色的角
luna nova school uniform=露娜诺瓦校服
hands on shoulders=双手放在肩膀上
brown tail=棕色的尾巴
stakes of purgatory=炼狱的赌注
long neck=长颈
chin strap=下巴带
leaf umbrella=叶子伞
post-apocalypse=后启示录
linked piercing=链接穿孔
butter=黄油
zora=佐拉
pink eyeshadow=粉色眼影
green socks=绿袜子
massage=按摩
blue-tinted eyewear=蓝色眼镜
wooden chair=木椅
group hug=环抱
panties under buruma=buruma 下的内裤
beetle=甲虫
tight dress=紧身连衣裙
mole on body=身上长痣
tea set=茶具
hand mirror=手镜
gokkun=吞咽
hair dryer=吹风机
dragon boy=龙童子
sugar cube=方糖
levitation=悬浮
kerchief=头巾
gold choker=金项圈
polka dot shirt=圆点衬衫
cheek pull=脸颊拉
american flag print=美国国旗印花
saunders school uniform=桑德斯校服
lipgloss=唇彩
variable fighter=可变战斗机
clown=小丑
family crest=家徽
omikuji=神签
hakurei shrine=没有神社
aqua bra=水好
keep out=避开
z-ring=Z形环
messy room=房间很乱
logo parody=徽标模仿
sitting on bench=坐在长凳上
lap pillow invitation=膝盖枕头邀请
plume=羽
sextuplets=六胞胎
print sarong=印花围裙
popped button=弹出按钮
floating cape=漂浮斗篷
implied fellatio=隐含的口交
band uniform=乐队制服
pumpkin hair ornament=南瓜发饰
beam=光束
kagami mochi=拿着镜子
argyle sweater=菱格纹毛衣
2007=2007
berry (pokemon)=浆果（口袋妖怪）
lizard=蜥蜴
hand on headphones=手放在耳机上
pegasus knight uniform (fire emblem)=飞马座骑士制服（火焰纹章）
fishing line=钓鱼线
head on hand=头在手边
zeon=曾是
sayagata=矢形
solid eyes=坚定的眼睛
blue feathers=蓝色的羽毛
meka (overwatch)=梅卡（守望先锋）
holomyth=完全神话
cart=大车
grand piano=大钢琴
pagoda=宝塔
jetpack=喷气背包
clothes theft=偷衣服
holding another's hair=抓着别人的头发
jingasa=精撒
juice=果汁
yellow sky=黄色的天空
sitting backwards=向后坐
pointing at another=指着另一个
condom box=安全套盒
fish boy=鱼仔
cardigan around waist=腰部开衫
green sclera=绿色巩膜
pegasus=飞马座
pussy juice drip through clothes=阴部汁液滴穿衣服
bishamonten's spear=毗沙门天枪
flower over eye=花过眼
head on chest=头靠在胸前
holding cane=拿着拐杖
forced orgasm=强迫性高潮
butterfly brooch=蝴蝶胸针
adjusting panties=调整内裤
steak=牛扒
green scrunchie=绿色发带
sauna=桑拿
wardrobe error=衣柜错误
japan=日本
crowbar=撬棍
sweaty clothes=汗湿的衣服
year of the dog=狗年
body armor=身体护具
pov across table=桌子对面的视角
height chart=身高图
ivy=常春藤
game boy=掌上游戏机
bear tail=熊尾巴
greek clothes=希腊衣服
prostration=顶礼
shoujo kitou-chuu=女孩缸
pixiv username=pixiv用户名
splattershot (splatoon)=飞溅（splatoon）
hungry=饥饿的
buruma aside=除了布鲁玛
skull necklace=骷髅项链
mount fuji=富士山
food-themed earrings=以食物为主题的耳环
hospital gown=病号服
cream on face=脸上的奶油
gunblade=枪刃
curled fingers=卷曲的手指
winding key=上链键
puppy=小狗
kissing penis=亲吻阴茎
soviet=苏联
ankle grab=脚踝抓
white day=白色情人节
wizard=巫师
radish=萝卜
infinity=无穷
sleeve grab=袖子抢
book hug=书抱
extra faces=多余的面孔
ferret=雪貂
acorn=橡子
ear protection=护耳
pink sky=粉红色的天空
falling feathers=飘落的羽毛
hitodama print=人的灵魂
clock eyes=钟眼
kiwi (fruit)=猕猴桃（水果）
military helmet=军用头盔
orange vest=橙色背心
cloth=布
dock=码头
strapless bottom=露肩底
nintendo 3ds=Nintendo 3但是
diving=潜水
bikini shorts=比基尼短裤
dress swimsuit=礼服泳装
minotaur=牛头怪
wrong feet=错误的脚
single epaulette=单肩章
french flag=法国国旗
sling bikini top=吊带比基尼上衣
testicle grab=睾丸抓
sickle=镰刀
between toes=脚趾之间
mat=随着
mitre=斜接
veiny arms=静脉手臂
adjusting necktie=调整领带
box of chocolates=盒装的巧克力
behind back=在背后
martial arts belt=武术腰带
pectoral focus=胸肌焦点
aurora=极光
jockstrap=背带
track uniform=田径服
army=军队
galaxy=星系
print mug=打印杯
leather pants=皮裤
model kit=模型套件
holding letter=拿着信
on motorcycle=在摩托车上
shell necklace=贝壳项链
blue sarong=蓝色围裙
whiskey=威士忌酒
salad=沙拉
mast=桅杆
silver dress=银色连衣裙
hair on horn=喇叭上的头发
above clouds=云之上
yellow tank top=黄色背心
battleship=战舰
lace choker=蕾丝项圈
guard rail=护栏
polka dot ribbon=圆点丝带
rei no pool=池 l 的示例
holding head=抱着头
butterfly sitting=蝴蝶坐
mmm threesome=嗯 三人组
white sarong=白围裙
box art=盒子艺术
pumpkin hat=南瓜帽
hanami=花见
hands on ground=手放在地上
rhodes island logo=罗德岛标志
throwing knife=飞刀
aqua neckerchief=水绿色围巾
clothesline=晾衣绳
bulletin board=布告栏
cross-laced legwear=交叉系带裤袜
keizoku school uniform=继续 s 和 l Unifor rm
track and field=田径
long tail=长尾巴
no mask=没有面具
shared speech bubble=共享气泡
oonusa=责任
gladiator sandals=角斗士凉鞋
seal (animal)=海豹（动物）
long earlobes=长耳垂
affectionate=亲热
pants tucked in=裤子塞进去
orange cape=橙色斗篷
hook=钩
detached hair=头发脱落
solid circle pupils=实心圆瞳孔
crane (animal)=鹤（动物）
vacuum cleaner=吸尘器
cleave gag=裂口
just the tip=只是冰山一角
pancake stack=煎饼堆
blue tank top=蓝色背心
sewing=缝纫
uneven twintails=参差不齐的双马尾
fishnet bodysuit=渔网连体衣
brown corset=棕色紧身胸衣
sock pull=袜子拉
lowleg skirt=低腿裙
pendulum=摆
gold footwear=金鞋
pool of blood=血泊
tengu mask=天狗面具
hair between breasts=乳房之间的头发
glove biting=咬手套
maid day=女佣日
folded hair=折叠的头发
pink-tinted eyewear=粉色眼镜
dragonfly=蜻蜓
inkwell=墨水池
implied yaoi=暗示矢追
miracle mallet=奇迹槌
fidgeting=坐立不安
stone stairs=石阶
livestream=现场直播
double horizontal stripe=双横条纹
nyan=那
triplets=三胞胎
qr code=二维码
cherry hair ornament=樱桃发饰
rabbit costume=兔子服装
implied fingering=暗示指法
holding money=拿着钱
holding jewelry=拿着首饰
holding own foot=抱着自己的脚
holding skull=拿着头骨
milky way=银河系
very wide shot=非常宽的镜头
stitched mouth=缝口
eye black=眼睛黑
in palm=在掌中
watching television=看电视
parrot=鹦鹉
severed limb=断肢
multicolored hairband=五彩发带
naked cloak=裸斗篷
multicolored stripes=五彩条纹
splatter=飞溅
foot hold=脚踏
cum in container=暨在容器
blood bag=血袋
knight (chess)=骑士（国际象棋）
year of the pig=猪年
symbolism=象征主义
ooarai (emblem)=ooarai（徽章）
caliburn (fate)=卡利本（命运）
covering one breast=覆盖一个乳房
lyre=七弦琴
bike shorts under shorts=短裤下的自行车短裤
green eyeshadow=绿色眼影
shindan maker=诊断损失
kyuudou=射箭
joystick=操纵杆
bag of chips=一袋薯条
white bird=白鸟
dream soul=梦魂
shrimp tempura=虾天妇罗
meta=元
italian text=意大利文
underbutt=动力不足
checkered shirt=格子衬衫
blood on arm=手臂上的血
ribbon-trimmed headwear=丝带饰边头饰
candlelight=烛光
light blue background=浅蓝色背景
green tail=绿色的尾巴
purple socks=紫色袜子
no jacket=没有夹克
kurokote=黑子
homu=奶牛
black garter straps=黑色吊袜带
broken window=破窗户
contrast=对比
musical note print=音符打印
cola=可乐
two-sided dress=双面连衣裙
grimoire of alice=爱丽丝的魔法书
afterglow=余辉
crumbs=面包屑
hair lift=头发提升
facebook username=脸书用户名
long toenails=长脚趾甲
self hug=自我拥抱
perfume bottle=香水瓶
purple ascot=紫色阿斯科特
shotgun shell=霰弹枪弹壳
ink (medium)=墨水（中）
sky print=天空打印
hand over eye=交出眼睛
alternate pectoral size=交替胸围大小
soap bottle=肥皂瓶
duel disk=决斗盘
baby bottle=婴儿奶瓶
grey wings=灰色的翅膀
arthropod limbs=节肢动物的四肢
frilled sailor collar=褶边水手领
tying=搭售
electric plug=电插头
syrup=糖浆
fingersmile=手指微笑
kickboard=浮板
roundel=圆形
heart on chest=胸前的心
crescent rose=新月玫瑰
hardhat=安全帽
koi=要求
bikini bottom removed=比基尼泳裤被移除
floating book=漂浮的书
goat=山羊
blue shawl=蓝色披肩
cast=投掷
masu=拥有者
age comparison=年龄比较
h&k ump=港股
bathrobe=浴衣
yamakasa=山笠
purple-tinted eyewear=紫色眼镜
floating weapon=浮动武器
behind-the-head headphones=头戴式耳机
watercolor pencil (medium)=水彩笔（中号）
blue bandana=蓝色头巾
skeleton print=骨架打印
propeller hair ornament=螺旋桨发饰
pink umbrella=粉色雨伞
duckling=小鸭子
first aid kit=急救箱
gun to head=枪口
digital dissolve=数字溶解
joestar birthmark=乔斯达胎记
ghost pose=幽灵姿势
bokura wa ima no naka de=我们现在很和谐
pineapple=菠萝
igote=射击手
sitting on shoulder=坐在肩膀上
single wrist cuff=单腕袖口
patchwork clothes=拼布衣服
walking on liquid=在液体上行走
shamoji=饭勺
breaking=打破
scylla=青蛙
weasel ears=黄鼠狼耳朵
hoodie lift=连帽衫升降机
groom=马夫
motosu school uniform=本栖校服
cyrillic=西里尔
food art=美食艺术
studded collar=铆钉领
camouflage headwear=迷彩头饰
blue pupils=蓝色瞳孔
platform boots=厚底靴
marshmallow=棉花糖
chikan=不同的
cat bag=猫袋
tooth=齿
spade hair ornament=铲形发饰
medallion=奖章
hair color connection=头发颜色连接
pig ears=猪耳朵
crazy straw=疯狂的稻草
two-sided skirt=两侧裙
calligraphy brush (medium)=毛笔（中）
brown flower=棕色的花
ak-47=and-47
blob=斑点
against railing=靠栏杆
alternate hair ornament=备用发饰
print sleeves=印花袖子
beretta 92=贝雷塔92
red tail=红尾巴
jacket over swimsuit=夹克套在泳衣上
tamagoyaki=玉子烧
cat mask=猫面具
necktie removed=领带被取下
wakamezake=裙带菜清酒
teeth hold=牙齿保持
checkered dress=格纹连衣裙
holding beachball=拿着沙滩球
two-tone leotard=双色紧身连衣裤
bridal legwear=新娘紧身裤
yellow-tinted eyewear=黄色眼镜
easter=复活节
missile pod=导弹舱
bowler hat=投球手有
clownfish=小丑鱼
biwa lute=喝啤酒
groceries=杂货
gibson les paul=吉布森保罗
gesugao=个素高
cumulonimbus cloud=积雨云
negative space=负空间
pelt=毛皮
tail around leg=尾巴绕着腿
hand tattoo=手纹身
craft essence (fate)=工艺精华（命运）
pinstripe suit=细条纹西装
golden arms=金臂
tracen swimsuit=Tracen 泳衣
grey leotard=灰色紧身衣
loaded interior=加载内部
gao=高
sitting on table=坐在桌子上
floating clothes=漂浮的衣服
hand rest=手托
usekh collar=衣领
shell hair ornament=贝壳发饰
wrist bow=腕弓
white mask=白色面具
cropped sweater=七分毛衣
protecting=保护
exposed pocket=外露口袋
red mask=红色面具
slim legs=修长的腿
hogwarts school uniform=霍格沃茨校服
animal slippers=动物拖鞋
little red riding hood (grimm) (cosplay)=小红帽（格林）（角色扮演）
eye trail=眼迹
soft serve=软服务
checkered legwear=格纹裤袜
grey tank top=灰色背心
side-tie peek=侧领带偷看
crisis management form (machimazo)=危机管理表（machimazo）
flying teardrops=飞行的泪珠
multiple torii=多个牌坊
two-finger salute=两指敬礼
cellphone charm=手机魅力
split theme=拆分主题
fur-trimmed footwear=毛皮边饰鞋
cracked floor=地板开裂
braiding hair=编头发
blue umbrella=蓝伞
green belt=绿化带
stuffed penguin=毛绒企鹅
pov doorway=pov门口
flat chest grab=平胸抓
unfastened=松开的
nail bat=指甲棒
seatbelt=安全带
arms between legs=双臂夹在两腿之间
centauroid=半人马座
plaid ribbon=格子丝带
wet towel=湿毛巾
sticker on face=脸上的贴纸
midriff sarashi=没有暴露
paint splatter on face=油漆溅在脸上
cattail=猫尾巴
object on breast=乳房上的物体
bunny day=兔日
starlight academy school uniform=星光学院校服
pants under skirt=裙子下的裤子
paw print pattern=爪印图案
peony (flower)=牡丹（花）
brown sleeves=棕色袖子
pastry bag=糕点袋
breasts on table=桌子上的乳房
walther=瓦尔特
cross tie=交叉领带
chrysanthemum=菊花
brown neckerchief=棕色围巾
sixteenth note=十六分音符
stuffed dog=毛绒狗狗
four-leaf clover hair ornament=四叶草发饰
year of the rooster=鸡年
person on head=头上的人
lifebuoy ornament=救生圈装饰品
yellow socks=黄袜子
animal on hand=手边的动物
red mittens=红色连指手套
rabbit on head=头上的兔子
qingxin flower=清新flower
hatsune miku=初音未来
hakurei reimu=博丽灵梦
kirisame marisa=雾雨魔理沙
remilia scarlet=蕾米莉亚猩红
flandre scarlet=佛兰德猩红
izayoi sakuya=是时候制作了
admiral (kancolle)=海军上将 (Kanakle)
artoria pendragon (fate)=阿尔托利亚·潘德拉贡（命运）
alice margatroid=爱丽丝玛格特罗
kochiya sanae=我不知道
patchouli knowledge=广藿香知识
konpaku youmu=灵魂幽梦
cirno=城市的
yakumo yukari=也与
komeiji koishi=公明路鹅卵石
shameimaru aya=沙明丸绫
fujiwara no mokou=藤原之母
reisen udongein inaba=旅行乌东根稻叶
hong meiling=红美玲
akemi homura=明美火焰
komeiji satori=公明治悟
kaname madoka=小圆
saigyouji yuyuko=上次活动悠悠子
kaga (kancolle)=(cancolle)
inubashiri momiji=狗跑秋叶
yakumo ran=关于专栏
kagamine rin=镜峰林
konpaku youmu (ghost)=Konpaku 无用（g 助手）
moriya suwako=森林与诹访湖
rumia=丑陋的
miki sayaka=三木沙耶加
kaenbyou rin=火病林
kazami yuuka=风见宝
shimakaze (kancolle)=岛风
reiuji utsuho=Reiwuji Utsuho
saber=知道
hibiki (kancolle)=声音
chen=陈
kamishirasawa keine=上白泽系统
tatara kogasa=tatara 老伞
kawashiro nitori=川城宜取
mash kyrielight=马修基里莱特
hinanawi tenshi=Hinanawi 天使
sakura kyouko=樱花
tomoe mami=巴真美
shigure (kancolle)=时雨 (Kanko)
houraisan kaguya=宝来辉夜山
koakuma=小恶魔
kongou (kancolle)=控偶 (看错哦来了)
ganyu (genshin impact)=输入（Genshin Impacter CT）
mystia lorelei=罗蕾莱的秘密
inaba tewi=稻叶哑巴
ibuki suika=呼吸西瓜
inazuma (kancolle)=闪电
souryuu asuka langley=苍龙明日香兰利
hijiri byakuren=圣白莲
akagi (kancolle)=赤木
nazrin=纳兹林
kagamine len=镜峰连
houjuu nue=后句u虐
tenryuu (kancolle)=天龙
tamamo (fate)=玉藻（妖精）
yuudachi (kancolle)=淋浴
yagokoro eirin=矢护永琳
yasaka kanako=爬到我身上
megurine luka=梅格林乌卡
ikazuchi (kancolle)=雷
jeanne d'arc alter (fate)=圣女贞德改变（命运）
mizuhashi parsee=水桥解析
abigail williams (fate)=阿比盖尔·威廉姆斯（命运）
fubuki (kancolle)=暴风雪
akiyama mio=秋山澪
akatsuki (kancolle)=黎明
zuikaku (kancolle)=瑞鹤（观光）
fujimaru ritsuka (female)=藤丸率？
fujimaru ritsuka (male)=是费藤丸吗？
toyosatomimi no miko=丰里见巫女
nagato (kancolle)=长门
hamakaze (kancolle)=滨风
morichika rinnosuke=森亲凛之助
haruna (kancolle)=榛名 (Kanakle)
suzumiya haruhi=凉宫春日
fate testarossa=红发
link=关联
hoshiguma yuugi=细熊游戏
pikachu=皮卡丘
raiden shogun=雷电书军
nero claudius (fate)=尼禄·克劳狄乌斯（命运）
kashima (kancolle)=鹿岛
nakano azusa=梓
gawr gura=打巨人
houshou marine=厚寿海洋
kagiyama hina=卡齐姆是次等的
tohsaka rin=远坂林
shanghai doll=上海娃娃
nagato yuki=长门雪
nishizumi miho=三浦西住
wriggle nightbug=蠕动夜虫
rem (re:zero)=rem（重新：零）
daiyousei=带有SEI
mononobe no futo=物部的脚
avatar (ff14)=化身 (ff14)
ryuujou (kancolle)=粒状
hirasawa yui=平泽唯
shiki eiki=公式
kyubey=立方体
onozuka komachi=小野冢小町
suzuya (kancolle)=铃屋
scathach (fate)=命运
usami renko=小胡子莲子
lumine (genshin impact)=lumine（原神冲击）
misaka mikoto=美琴上去了
tifa lockhart=蒂法洛克哈特
inkling=暗示
takamachi nanoha=菜叶高町
yorha no. 2 type b=约哈号2 b型
toramaru shou=虎丸病
illyasviel von einzbern=来自爱因兹贝伦的伊利亚斯菲尔
houshou (kancolle)=后手 (看错哦来了)
maribel hearn=玛丽贝尔赫恩
imaizumi kagerou=今泉阳炎
ayanami rei=绫波例子
shigure kai ni (kancolle)=在时雨会（观光）
jeanne d'arc (fate)=圣女贞德（命运）
joseph joestar=约瑟夫乔斯达
yuudachi kai ni (kancolle)=在淋浴派对上
matoi ryuuko=缠龙子
tainaka ritsu=与介质的比率
hu tao (genshin impact)=Me Toh（原神）
producer (idolmaster)=制作人（偶像大师）
murakumo (kancolle)=村云
serval (kemono friends)=ser（kemono 朋友）
nishikino maki=锦卷
jeanne d'arc alter (avenger) (fate)=圣女贞德 (复仇者) (命运)
sonoda umi=大海
amatsukaze (kancolle)=天风 (Kanko)
himekaidou hatate=姬凯多竖版
northern ocean princess=北洋公主
ushio (kancolle)=浪潮
shibuya rin=涉谷林
toujou nozomi=还是希望
princess zelda=塞尔达公主
zhongli (genshin impact)=中立 (跟室内impact)
okita souji (fate)=醒来打扫（缘分）
atago (kancolle)=爱宕（kancolle）
kaku seiga=每个性别
yukikaze (kancolle)=雪风（勘光）
shoukaku (kancolle)=晋升
murasa minamitsu=村佐南津
inkling girl=暗示女孩
yazawa nico=下雨了
kafuu chino=当地的
ayase eli=催化剂
tamamo no mae (fate/extra)=在玉藻面前
yamato (kancolle)=大和
dawn (pokemon)=黎明（口袋妖怪）
shirakami fubuki=白神吹雪
nagae iku=长柄
manjuu (azur lane)=manjuu（碧蓝航线）
usada pekora=用过的pekora
joseph joestar (young)=约瑟夫·乔斯达（年轻）
akebono (kancolle)=曙光（勘光）
hata no kokoro=旗心
kitakami (kancolle)=北上
kujo jotaro=灭绝
gilgamesh (fate)=吉尔伽美什（命运）
ibaraki kasen=茨城川
megumin=惠惠
kaito (vocaloid)=快斗（vocaloid）
rensouhou-chan=人搜后-产
lillie (pokemon)=莉莉丝（口袋妖怪）
matou sakura=樱花
mona (genshin impact)=梦娜 (Genshin Impacter CT)
yae miko=八重巫女
shuten douji (fate)=主点同时（缘分）
kumoi ichirin=云井一和
kurodani yamame=黑田的山目鳟鱼
kasodani kyouko=人口减少的螨虫强
soga no tojiko=苏我与自己
miyako yoshika=宫古义香
prinz eugen (kancolle)=尤金王子 (kancolle)
hoshii miki=想要干
ooyodo (kancolle)=ooyodo（kancolle）
kotobuki tsumugi=寿瑠
keqing (genshin impact)=客卿（原神冲击）
astolfo (fate)=阿斯托尔福（精灵）
female admiral (kancolle)=女海军上将（kancolle）
chun-li=春-李
darjeeling (girls und panzer)=大吉岭（少女与装甲）
hiiragi kagami=柊火神
mutsu (kancolle)=陆奥
tatsuta (kancolle)=辰田
cu chulainn (fate)=cu chulainn（命运）
asashio (kancolle)=晨潮
may (pokemon)=可能（口袋妖怪）
byleth (fire emblem)=比莱斯（火焰纹章）
kijin seija=古怪的圣人
pyra (xenoblade)=火（xenobladi）
kinomoto sakura=木之本樱
mori calliope=森风琴
clownpiece=小丑
nishizumi maho=西住真帆
ninomae ina'nis=二之前No's
minami kotori=南鸟
rosa (pokemon)=粉红色（口袋妖怪）
kaban (kemono friends)=Kaban（野兽 f 离婚 ds）
yor briar=你的野蔷薇
emiya shirou=了解卫宫
minato aqua=矿泉水
itsumi erika=埃里卡·伊兹米
c.c.=抄送
meiko (vocaloid)=meiko（vocaloid）
samus aran=萨姆阿兰
aki minoriko=秋实子
hilda (pokemon)=希尔达（口袋妖怪）
bismarck (kancolle)=俾斯麦（kancolle）
archer (fate)=射手（命运）
mordred (fate)=莫德雷德（命运）
aether (genshin impact)=以太（原神冲击）
sendai (kancolle)=Sendai (看错哦来了)
marnie (pokemon)=玛妮（口袋妖怪）
minamoto no raikou (fate)=Gen的访问学校（命运）
ooi (kancolle)=母羊（kancolle）
yuzuki yukari=结月由香里
izumi konata=泉知道
hieda no akyuu=飞騨之秋
caesar anthonio zeppeli=凯撒·安东尼·齐贝利
akashi (kancolle)=证明
sekibanki=红色野蛮
amami haruka=甜蜜遥
anchovy (girls und panzer)=凤尾鱼（少女与装甲）
takao (kancolle)=炸玉米饼（Kanakle）
musashi (kancolle)=武藏
nanami chiaki=七海千秋
junko (touhou)=纯子（欲望）
yoko littner=洋子利特纳
mythra (xenoblade)=密特拉（异度神剑）
nero claudius (fate/extra)=尼禄·克劳狄乌斯（命运/额外）
okita souji (koha-ace)=起床打扫（小哈汗）
amiya (arknights)=amiya（明日方舟）
shiranui (kancolle)=不知火
tsukino usagi=月亮兔
d.va (overwatch)=d.va（守望先锋）
kousaka honoka=身高或微弱
futatsuiwa mamizou=二井岩真水藏
wo-class aircraft carrier=两级航母
asuna (sao)=亚丝娜（sao）
medusa (fate)=水母（仙女）
sazanami (kancolle)=Sazanami (Kanakle)
souryuu (kancolle)=苍龙（Kanko）
sukuna shinmyoumaru=他的腿是 shinmyoumaru
yamashiro (kancolle)=山城
shijou takane=市场高点
aki shizuha=秋静羽
samidare (kancolle)=可能会下雨
watson amelia=华生阿米莉亚
akiyama yukari=秋山由香里
hiei (kancolle)=hiei（kancolle）
suigintou=汞灯
ro-500 (kancolle)=ro-500 (kancolle)
senketsu=新鲜血液
gloria (pokemon)=格洛丽亚（口袋妖怪）
cloud strife=云争
hk416 (girls' frontline)=hk416（少女前线）
takanashi kiara=Kiara 高梨
kisaragi chihaya=如月千早
dio brando=品牌神
gumi=十
klee (genshin impact)=klee（原神冲击）
kirishima (kancolle)=雾岛
verniy (kancolle)=漆
letty whiterock=莱蒂·怀特罗克
gardevoir=沙奈朵
venti (genshin impact)=Venti（Gemshim Impact）
kiryuuin satsuki=桐生院小月
mordred (fate/apocrypha)=莫德雷德（命运/外典）
minase iori=水瀬安
nekomata okayu=猫又粥
kikuchi makoto=菊地诚
hoshizora rin=星空森林
bb (fate)=bb（命运）
kasumi (kancolle)=利润 (kancolle)
iowa (kancolle)=爱荷华州（大学）
ex-keine=前无
byleth (fire emblem) (female)=比雷丝（火焰纹章）（女）
hecatia lapislazuli=青金石
jeanne d'arc (ruler) (fate)=圣女贞德（统治者）（命运）
texas (arknights)=德克萨斯州（明日方舟）
atago (azur lane)=爱宕（碧蓝航线）
saber alter=军刀改变
oshino shinobu=忍野忍
ganaha hibiki=爱哭
taihou (azur lane)=太后 (A族人lane)
yuubari (kancolle)=夕张（Kanakle）
kiso (kancolle)=基本
doctor (arknights)=医生（明日方舟）
shimamura uzuki=岛村漩月
tartaglia (genshin impact)=tartaglia（原神冲击）
princess peach=桃子公主
uruha rushia=俄语
ash ketchum=灰番茄酱
watanabe you=渡边你
zero two (darling in the franxx)=零二 (darling in the franxx)
hoshimachi suisei=星贝水性
aerith gainsborough=爱丽丝·盖恩斯伯勒
morrigan aensland=莫里根岛
makima (chainsaw man)=手工制作（电锯人）
asahina mikuru=朝比奈实来
red (pokemon)=红色（口袋妖怪）
asuna (blue archive)=亚丝娜（蓝色存档）
shirogane noel=白金画
skadi (arknights)=斯卡迪（明日方舟）
formidable (azur lane)=强大的（碧蓝航线）
shirasaka koume=白坂小梅
hiryuu (kancolle)=飞龙
prinz eugen (azur lane)=尤金王子（碧蓝航线）
karyl (princess connect!)=karyl（公主连结！）
takagaki kaede=高垣枫
meltryllis (fate)=meltryllis（命运）
djeeta (granblue fantasy)=d 明白了（g column bue fantasy）
sagisawa fumika=鹭泽文香
graf zeppelin (kancolle)=坟墓飞艇 (kancolle)
ultimate madoka=终极小圆
bremerton (azur lane)=布雷默顿（碧蓝航线）
rice shower (umamusume)=米淋浴 (umamusume)
komaeda nagito=狛枝凪
wakasagihime=若鹭公主
inugami korone=狗不是冠冕
paimon (genshin impact)=Paimon (Genshin Impacter CT)
sakura miko=樱花巫女
kirby=柯比
kishin sagume=捐赠佐木
eula (genshin impact)=eula（原神影响）
medusa (rider) (fate)=美杜莎（骑手）（仙女）
koizumi hanayo=小泉花阳
tokoyami towa=永恒的黑暗
mejiro mcqueen (umamusume)=白眼mc广场花园（马女）
yumemi riamu=利亚姆梦美
takatsuki yayoi=高槻弥生
miyamoto musashi (fate)=宫本武藏（命运）
kyon=为什么
hestia (danmachi)=Hes Chia (Danmachi)
naka (kancolle)=中间
black rock shooter (character)=黑岩射手（角色）
bowsette=蝴蝶结
selene (pokemon)=塞勒涅（口袋妖怪）
belfast (azur lane)=贝尔法斯特（碧蓝航线）
sirius (azur lane)=天狼星（碧蓝航线）
kanzaki ranko=神崎辉子
amane kanata=这样的边缘
oozora subaru=天空斯巴鲁
ishtar (fate)=伊什塔尔（命运）
super sonico=超音速
daiwa scarlet (umamusume)=大和之变（马娘）
kisume=吻我
jougasaki mika=城崎美嘉
ikari shinji=愤怒
cu chulainn (fate/stay night)=cu chulainn（命运/住宿之夜）
seaport princess=海港公主
narukami yuu=鸣上优
lily white=白百合
kiryu coco=可可桐生
aqua (konosuba)=阿库亚（Konosuba）
furude rika=全面科学
cynthia (pokemon)=辛西娅（口袋妖怪）
fairy (kancolle)=妖精（kancolle）
takebe saori=武部纱织
i-19 (kancolle)=i-19 (kancolle)
kamisato ayaka=上里绫香
ereshkigal (fate)=ereshkigal（男孩）
tsushima yoshiko=对马芳子
sailor moon=美少女战士
zuihou (kancolle)=最后 (看错哦来了)
kuroki tomoko=黑智子
ookami mio=狼澪
gokou ruri=项目 5 琉璃
barnaby brooks jr.=小巴纳比布鲁克斯
cammy white=卡米白
sanya v. litvyak=雪橇进来。利维亚克
nitta minami=南真太
kakyoin noriaki=御史纪明
unicorn (azur lane)=独角兽（碧蓝航线）
eila ilmatar juutilainen=埃拉·伊尔玛塔·尤蒂莱宁
lucina (fire emblem)=露西娜（火焰纹章）
serena (pokemon)=瑟琳娜（口袋妖怪）
ahri (league of legends)=阿狸（英雄联盟）
hinata hajime=日向始
trainer (umamusume)=教练（umamusume）
corrin (fire emblem)=Corrin（火焰纹章）
stocking (psg)=放养 (psg)
ichinose shiki=一之濑风格
ouma kokichi=马幸吉
kaburagi t. kotetsu=Kaburagi t。甲铁
naganami (kancolle)=Nagnami（卡纳克勒）
haruno sakura=春天的樱花
medicine melancholy=医学忧郁
i-58 (kancolle)=i-58 (kancolle)
shenhe (genshin impact)=审核 (跟室内impact)
yukihana lamy=雪花拉米
lunasa prismriver=月神棱镜河
commander (azur lane)=指挥官（碧蓝航线）
kitagawa marin=北边马林
ouro kronii=克罗尼黄金
higuchi madoka=樋口圆
maya (kancolle)=玛雅人（卡纳克勒）
kokkoro (princess connect!)=kokkoro（公主连结！）
son goku=损失国家
yagami hayate=大风谷上
kotomine kirei=言峰绮礼
yamakaze (kancolle)=山风（勘光）
murasame (kancolle)=村雨
anastasia (idolmaster)=阿纳斯塔西娅（偶像大师）
hiiragi tsukasa=柊司
gold ship (umamusume)=黄金船（umamusume）
xiao (genshin impact)=小 (跟室内impact)
nanashi mumei=没有名字没有名字
kirito=桐人
edelgard von hresvelg=埃德尔加德·冯·赫雷斯维尔格
doremy sweet=甜甜的
midoriya izuku=绿屋伊豆区
shishiro botan=白色按钮
misty (pokemon)=迷雾（口袋妖怪）
florence nightingale (fate)=佛罗伦萨夜莺（命运）
shirogane naoto=白金之声
mercy (overwatch)=怜悯（守望先锋）
kujo jolyne=九条jolyne
jack the ripper (fate/apocrypha)=开膛手杰克（命运/伪经）
sakurauchi riko=樱内俊美
boo tao (genshin impact)=boo man (genshin impact)
katyusha (girls und panzer)=喀秋莎（少女与装甲）
giorno giovanna=琼戴
kay (girls und panzer)=凯（少女与装甲）
nia teppelin=尼亚特佩林
shimada arisu=岛田爱丽丝
tokai teio (umamusume)=Toei Tei (Uma Musume)
ump45 (girls' frontline)=ump45（少女前线）
nami (one piece)=纳米（一件）
uzumaki naruto=漩涡鸣人
z1 leberecht maass (kancolle)=z1 leberecht maass (kancolle)
sheryl nome=谢丽尔·诺姆
pecorine (princess connect!)=pecorine（公主连结！）
murasaki shion=紫锡安
ayanami (azur lane)=绫波（碧蓝航线）
futaba anzu=双叶庵
uraraka ochako=浦良茶子
saihara shuuichi=西原修一
takarada rikka=立花宝田
anya (spy x family)=安雅（间谍x家族）
miura azusa=三浦梓
taihou (kancolle)=太后 (看错哦来了)
z3 max schultz (kancolle)=z3 最大舒尔茨 (kancolle)
mario=马里奥
eevee=伊布
iskandar (fate)=依斯干达（命运）
akigumo (kancolle)=秋云
kuma (kancolle)=和（cancolle）
waver velvet=波浪绒
hyuuga hinata=日向日向
mikasa ackerman=三笠阿克曼
jonathan joestar=乔纳森·乔斯达
barbara (genshin impact)=芭芭拉 (genshin impact)
hagiwara yukiho=萩原行步
warspite (kancolle)=厌战 (kancolle)
fusou (kancolle)=扶桑
chloe von einzbern=克洛伊·冯·爱因兹贝伦
narmaya (granblue fantasy)=narmaya（碧蓝幻想）
shirai kuroko=白井黑子
i-401 (kancolle)=i-401 (kancolle)
motoori kosuzu=回转小津
jougasaki rika=城崎理香
leon (pokemon)=里昂（口袋妖怪）
non-human admiral (kancolle)=非人类海军上将（Kanakle）
izumi sagiri=泉纱雾
aisaka taiga=大阪带
ryuuguu rena=龙宫玲奈
yuki miku=雪未来
reizei mako=曾经的真子
usami sumireko=宇佐见澄子
common raccoon (kemono friends)=普通浣熊（kemono 朋友）
elizabeth bathory (fate)=伊丽莎白·巴托里（命运）
asuna (bunny) (blue archive)=亚丝娜（兔子）（蓝色存档）
pyonta=化脓的
hoto cocoa=照片可可
midorikawa nao=绿川直
kumano (kancolle)=熊
ruby rose=红宝石玫瑰
lelouch lamperouge=鲁路修·兰佩鲁吉
kama (fate)=作为（脂肪）
satonaka chie=里中智慧
lappland (arknights)=拉普兰（明日方舟）
holo=跑步
raihan (pokemon)=成就（口袋妖怪）
higashikata josuke=东方宗介
monster hunter (character)=怪物猎人（角色）
ch'en (arknights)=陈（明日方舟）
kise yayoi=礼服弥生
mankanshoku mako=万堪食真子
beatrice (umineko)=Bear t Lycee (Umineko)
jean (genshin impact)=让（原神冲击）
shiranui mai=不知火饭
maekawa miku=前川美来
aoba (kancolle)=奥巴 (看错哦来了)
hyuuga (kancolle)=Hulauga（骷髅）
fischl (genshin impact)=fischl（原神冲击）
emilia (re:zero)=艾米利亚（回复：零）
tokitsukaze (kancolle)=时津风
akizuki ritsuko=秋月律子
kiyohime (fate)=清姬（法塔赫）
charlotte (madoka magica)=夏洛特（魔法小圆）
nakiri ayame=薙切彩目
robin (fire emblem)=知更鸟（火焰纹章）
luna child=月神之子
star sapphire=星蓝宝石
fennec (kemono friends)=fennec（kemono 朋友）
illustrious (azur lane)=杰出的（碧蓝航线）
oboro (kancolle)=奥博罗
tomoe gozen (fate)=Tomoe Morning（法塔赫）
bea (pokemon)=bea（口袋妖怪）
boko (girls und panzer)=boko（少女与装甲）
natsuiro matsuri=夏季色彩节
mogami (kancolle)=最上（kancolle）
unzan=云山
shiranui flare=不知火火
satsuki (kancolle)=小月
ashigara (kancolle)=足柄
kousaka kirino=高度或切割
sakamata chloe=应该是克洛伊
weiss schnee=白雪
exusiai (arknights)=exusiai（明日方舟）
artoria pendragon (lancer) (fate)=artoria pendragon (lancer) (fate)
yorigami shion=一心紫苑
jintsuu (kancolle)=阵痛
uzuki (kancolle)=宇月
kiyoshimo (kancolle)=清茂 (Kanko)
kagerou (kancolle)=热浪
makise kurisu=牧濑克里斯
urakaze (kancolle)=浦风
sunny milk=阳光牛奶
tachibana arisu=立花爱丽丝
isokaze (kancolle)=矶风
takami chika=高地
nitocris (fate)=nitocris（仙女）
nessa (pokemon)=内萨（口袋妖怪）
corrin (fire emblem) (female)=Corrin（火焰纹章）（女）
kallen stadtfeld=卡伦施塔特费尔德
emiya kiritsugu=卫宫切嗣
erica hartmann=艾丽卡·哈特曼
miyafuji yoshika=宫藤佳香
unryuu (kancolle)=云龙 (Kanko)
hatsuyuki (kancolle)=第一场雪
koshimizu sachiko=小清水幸子
nakano nino=在里面
shiratsuyu (kancolle)=白露
karin (blue archive)=卡琳（蓝色档案）
houjou satoko=北条聪子
diarmuid ua duibhne (lancer) (fate)=diarmuid ua duhne (lancer) (命运)
dizzy (guilty gear)=头晕目眩（罪恶装备）
hayami kanade=早水奏
hishikawa rikka=立花菱川
mika (girls und panzer)=米卡（少女与装甲）
power (chainsaw man)=力量（电锯人）
don-chan (usada pekora)=东酱（宇佐田佩可拉）
ram (re:zero)=ram（回复：零）
taigei (kancolle)=taigei (kancolle)
akitsu maru (kancolle)=秋津丸
asakura ryouko=朝仓凉子
simon (ttgl)=西蒙 (ttgl)
alice (alice in wonderland)=爱丽丝（爱丽丝梦游仙境）
wa2000 (girls' frontline)=wa2000（少女前线）
bakugou katsuki=爆豪克月
nakano miku=米库在中间
callie (splatoon)=卡莉（喷射战士）
oda nobunaga (fate)=织田信长（命运）
agnes tachyon (umamusume)=Ag 值 s 其他 c 哥 (Uma Musume)
gertrud barkhorn=格特鲁德·巴克霍恩
aoki reika=青木冷冻甜点
futami mami=奔跑的妈妈
dark magician girl=黑魔法少女
yoshida yuuko (machikado mazoku)=吉田由子（街角恶魔）
kirima syaro=让我们清楚
yelan (genshin impact)=夜岚（原神冲击）
nishikigi chisato=锦千里
hatsuzuki (kancolle)=第一个月
nagisa kaworu=渚薰
michishio (kancolle)=高潮
saratoga (kancolle)=萨拉托加（卡纳克勒）
surtr (arknights)=surtr（明日方舟）
louise francoise le blanc de la valliere=路易丝·弗朗索瓦丝·勒·布兰克·德拉瓦利埃
kiana kaslana=琪亚娜卡斯拉娜
accelerator (toaru majutsu no index)=阿瑟拉和r（某魔法x的成员）
harusame (kancolle)=粉丝（Kanko）
makinami mari illustrious=macinami 玛丽杰出
arcueid brunestud=arcuid 布鲁内斯特
kamijou touma=上条和马
shana=夏娜
katsushika hokusai (fate)=葛饰北斋（命运）
tachibana kanade=立花奏
shiroko (blue archive)=宽（蓝光文件）
merlin prismriver=梅林棱镜河
takao (azur lane)=高雄（碧蓝航线）
kamado nezuko=灶门祢豆子
marie (splatoon)=玛丽（喷射战士）
yura (kancolle)=由良 (Kanakle)
re-class battleship=重级战列舰
miyu edelfelt=米娅埃德费尔特
ranka lee=李兰
chitanda eru=千反田得到
ushiromiya battler=内宫刑
u-511 (kancolle)=u-511 (kancolle)
lyrica prismriver=棱镜河
kaenbyou rin (cat)=kaenbyou rin (猫)
kirigiri kyouko=基里基里强
hino akane (smile precure!)=日野茜（微笑precure！）
amamiya ren=甜与仁
kanna kamui=一样
yahagi (kancolle)=Yehgi（卡纳克勒）
nahida (genshin impact)=nahida (genshin impact)
reisalin stout=雷萨林烈性黑啤酒
yukine chris=尤金克里斯
isuzu hana=五十铃花
kashiwazaki sena=柏崎圣奈
lana (pokemon)=拉娜（口袋妖怪）
amber (genshin impact)=琥珀色（原神冲击）
mutsuki (kancolle)=睦月
kyonko=为什么
tippy (gochiusa)=奇比 (gochiusa)
ethan (pokemon)=伊桑（口袋妖怪）
laffey (azur lane)=拉菲（碧蓝航线）
t-head admiral=T头海军上将
yuuki makoto=有机真实
enterprise (azur lane)=企业（碧蓝航线）
akai haato=红色的叶子
haguro (kancolle)=羽黑 (kancolle)
toshinou kyouko=强的
enoshima junko=江之岛纯子
mudrock (arknights)=泥岩（明日方舟）
kal'tsit (arknights)=凯尔希特（明日方舟）
tamamo cat (fate)=玉藻猫（妖精）
i-8 (kancolle)=i-8 (kancolle)
atlanta (kancolle)=亚特兰大 (kancolle)
abukuma (kancolle)=abukuma（kancolle）
uchiha sasuke=宇智波佐助
napoleon bonaparte (fate)=拿破仑·波拿巴（命运）
hanekawa tsubasa=羽川翼
nilou (genshin impact)=nilou（原神冲击）
mayuzumi fuyuko=真泉冬子
shinku=你
tone (kancolle)=音调（kancolle）
akizuki (kancolle)=秋月 (kancolle)
qiqi (genshin impact)=琪琪 (跟室内impact)
houjou hibiki=北条响
futami ami=运行哪个
akari (pokemon)=光（口袋妖怪）
kousaka tamaki=身高或戒指
yorigami jo'on=去河边
akagi (azur lane)=为什么（碧蓝航线）
bronya zaychik=盔甲兔
shokuhou misaki=联系斗篷
jeanne d'arc alter (swimsuit berserker) (fate)=珍妮·达克·阿尔特（泳装狂战士）（命运）
gran (granblue fantasy)=gran（碧蓝幻想）
sangonomiya kokomi=分娩后的科科米
kurosawa dia=亲爱的黑泽明
hina (blue archive)=hina（蓝色存档）
blue oak=蓝橡木
takanashi rikka=立花贵梨
aida mana=还有谁
kisaragi (kancolle)=如月 (Kanakle)
junketsu=纯血统
eren yeager=荣誉耶格尔
rowlet=小船
matsuura kanan=迦南松浦
hilbert (pokemon)=希尔伯特（口袋妖怪）
yang xiao long=杨小龙
kagari atsuko=Atsuko Cagalli
diluc (genshin impact)=迪卢克（genshin impact）
amagi yukiko=天城由纪子
bb (fate/extra)=bb（命运/额外）
la+ darknesss=la+黑暗
matara okina=鳕鱼老人
ia (vocaloid)=ia (vocaloid)
nonna (girls und panzer)=诺娜（少女与装甲）
akuma homura=恶魔火焰
kizuna akari=债券灯
nero claudius (swimsuit caster) (fate)=nero claudius（泳装施法者）（命运）
battleship princess=战舰公主
ump9 (girls' frontline)=ump9（少女前线）
ikamusume=伊卡苏梅
perrine h. clostermann=perrine h.克洛斯特曼
shikinami (kancolle)=式波
hakos baelz=哈科斯贝尔茨
kurumi erika=久留美绘梨香
kunikida hanamaru=国木田花丸
kamikaze (kancolle)=神风队
denji (chainsaw man)=电磁学（茶道w男）
han juri=半接受
gotou hitori=后藤一鸟
charlotte e. yeager=夏洛特 E.耶格尔
raiden mei=雷电名称
octoling=八角形
senjougahara hitagi=战场原日木
gambier bay (kancolle)=甘比尔湾（kancolle）
ise (kancolle)=它（脚踝）
akaza akari=他来来去去
tamamo no mae (swimsuit lancer) (fate)=Tamanmo no Mei (泳装Lancer) (Torn)
nakano yotsuba=四片叶子在
jun'you (kancolle)=均有 (看错哦来了)
hoshizora miyuki=星空美雪
miyuki (kancolle)=深雪
raising heart=提高心
kujikawa rise=九字川中学
anastasia (fate)=阿纳斯塔西娅（命运）
kaga (azur lane)=加贺（碧蓝航线）
gangut (kancolle)=甘古特 (Kanakle)
mirko=冷静的
silence suzuka (umamusume)=神背铃鹿 (Uma Musume)
fou (fate)=fou（命运）
pola (kancolle)=波拉 (Kanakle)
honda mio=我的本田
panty (psg)=内裤 (psg)
ohtsuki yui=用哦
hex maniac (pokemon)=十六进制疯子（口袋妖怪）
scaramouche (genshin impact)=scaramouche (genshin impact)
shinki (touhou)=新（东宝）
piplup=piplup
hassan of serenity (fate)=宁静的哈桑（命运）
lynette bishop=丽奈特主教
saten ruiko=缎
bb (swimsuit mooncancer) (fate)=bb（泳装月癌）（fate）
ryougi shiki=双重意义
suiseiseki=低分
yu mei-ren (fate)=愚昧-人 (fate)
sonozaki mion=园崎美园
fu hua=孵化
yuuka (blue archive)=yuuka（蓝色存档）
w (arknights)=w（明日方舟）
suzuran (arknights)=铃兰（明日方舟）
inkling boy=小男孩
lyra (pokemon)=天琴座（口袋妖怪）
nice nature (umamusume)=美丽的大自然 (umamusume)
tatsumaki=辰卷
i-168 (kancolle)=i-168 (kancolle)
avatar (ff11)=化身 (ff11)
irisviel von einzbern=爱丽丝菲尔·冯·爱因兹贝伦
charizard=喷火龙
tsukino mito=月亮的味道
kaedehara kazuha=枫原号
ibaraki douji (fate)=茨木同时（命运）
katsuki yuuri=有利
kurosawa ruby=黑泽红宝石
yuugumo (kancolle)=yuugumo (kancolle)
mallow (pokemon)=锦葵（口袋妖怪）
shoebill (kemono friends)=鲸头鹳（kemono 朋友）
inoue takina=一探究竟
p-head producer=p头制作人
nico robin=妮可罗宾
nia (xenoblade)=nia（异度神剑）
viktor nikiforov=维克多·尼基福罗夫
kochou shinobu=夸张的忍者
springfield (girls' frontline)=斯普林菲尔德（少女前线）
mash kyrielight (dangerous beast)=mash kyrielight（危险的野兽）
mostima (arknights)=mostima（明日方舟）
christa renz=克里斯塔·伦茨
jakuzure nonon=侬侬
nachi (kancolle)=纳粹
meltryllis (swimsuit lancer) (fate)=meltryllis（泳装lancer）（命运）
makigumo (kancolle)=坎科尔
neptune (neptune series)=海王星（海王星系列）
vita=生活
rotom=用嘴
miyamoto frederica=宫本弗雷德里卡
vivio=活过
orange pekoe (girls und panzer)=橙色白毫（少女与装甲）
lysithea von ordelia=丽西娅·冯·奥德莉亚
akamatsu kaede=赤松枫
noumi kudryavka=努米库德里亚夫卡
brendan (pokemon)=布伦丹（口袋妖怪）
rosalina=罗莎琳娜
elizabeth bathory (fate/extra ccc)=伊丽莎白·巴托里（命运/额外的 ccc）
lyn (fire emblem)=林（火焰纹章）
ujimatsu chiya=宇岛松千也
android 18=机器人 18
akagi miria=米利亚·赤城
tedeza rize=双手坐姿
sakura miku=樱花未来
choukai (kancolle)=抽开 (看错哦来了)
mysterious heroine xx (fate)=神秘女主角xx（命运）
gojou satoru=五条悟
sesshouin kiara=杀生院祈荒
jeanne d'arc alter santa lily (fate)=圣女贞德改变圣百合（命运）
johnny joestar=约翰尼·乔明星
maru-yu (kancolle)=马如-与 (看错哦来了)
blake belladonna=布莱克颠茄
tsunomaki watame=角卷棉
lilith aensland=莉莉丝岛
nagatsuki (kancolle)=永月
shinjou akane=心情茜
yuzuriha inori=祈祷是一种收获
nero claudius (bride) (fate)=nero claudius（新娘）（命运）
hilda valentine goneril=希尔达情人节高纳里尔
katsuragi (kancolle)=葛城
yoimiya (genshin impact)=Yoimiya (Haragami Impa CT)
shima rin=岛屿森林
akatsuki kirika=晓雾化
kenzaki makoto=健崎诚
sonia (pokemon)=索尼娅（口袋妖怪）
takara miyuki=宝美雪
shinomiya kaguya=四宫辉夜
morpeko=大罪
index (toaru majutsu no index)=In x（某魔法成员x）
mima (touhou)=比（toh）
sinon=否则
bardiche=吟游诗人
toga himiko=门是姬子
javelin (azur lane)=标枪（碧蓝航线）
teruzuki (kancolle)=我爱 teru (Kanko)
noshiro (kancolle)=能代
phosphophyllite=磷叶石
sakamoto mio=坂本澪
hiro (darling in the franxx)=hiro (darling in the franxx)
yowane haku=夜深人静
tachibana hibiki (symphogear)=Tachibana Hibiki（症状补充齿轮）
mizuno ami=美津浓哪个
koizumi itsuki=小泉树
tama (kancolle)=你（kankolle）
pepperoni (girls und panzer)=意大利辣香肠（少女与装甲）
lucky beast (kemono friends)=幸运兽（kemono 朋友）
aegis (persona)=宙斯盾（人）
morikubo nono=森洼野野
iono (pokemon)=Iono（口袋妖怪）
lum=卢姆
last order (toaru majutsu no index)=Ast r de r（某魔法成员de x）
gotland (kancolle)=哥特兰岛（卡纳克勒）
yayoi (kancolle)=弥生（准确）
suzukaze (kancolle)=凉风
asui tsuyu=降水雨季
manhattan cafe (umamusume)=曼哈顿咖啡馆（乌玛娘）
sensei (blue archive)=老师（蓝色档案）
asashio kai ni (kancolle)=在早潮派对（Kanko）
ningguang (genshin impact)=凝光 (跟室内impact)
dodoco (genshin impact)=dodoco（原神冲击）
andou (girls und panzer)=andou（少女与装甲）
yae sakura=八重樱
shirayuki (kancolle)=白雪公主
kuroshio (kancolle)=黑潮
signum=符号
ceres fauna=谷神星动物群
ak-12 (girls' frontline)=ak-12（少女前线）
hanamura yousuke=花村洋介
darkness (konosuba)=Hit rk heat s (Konosuba)
makoto nanaya=七谷诚
shiomi syuko=汐见修子
chiyoda momo=千代田桃
aino minako=爱美奈子
kirino ranmaru=桐乃兰丸
st. louis (azur lane)=英石。路易斯（碧蓝航线）
hanasaki tsubomi=鼻尖
n (pokemon)=N（口袋妖怪）
lucario=路卡利欧
morgan le fay (fate)=摩根勒菲（命运）
noel vermillion=诺埃尔朱砂
seiran (touhou)=蓝靛蓝（东宝）
jinx (league of legends)=厄运（英雄联盟）
special week (umamusume)=特别周 (umamusume)
tracer (overwatch)=示踪剂（守望先锋）
asashimo (kancolle)=朝下
suzutsuki (kancolle)=有铃铛
producer (idolmaster cinderella girls anime)=制作人（偶像大师灰姑娘女孩动漫）
twilight (spy x family)=暮光之城（间谍x家族）
matou kariya=马托村
oda nobunaga (koha-ace)=织田信长（小汗）
matsuno karamatsu=等待松树
hachimiya meguru=八宫之旅
kasumi (doa)=霞（门）
lio fotia=照片马
horikawa raiko=堀川赖子
saber lily=军刀百合
shiomi kotone=潮见琴音
otonashi kotori=没有声音的小鸟
moroboshi kirari=师星绮良里
sakata gintoki=坂田银时
oumae kumiko=久美子
matsuno jyushimatsu=松脂松
kizuna ai=债券的爱
sakurai momoka=樱井桃香
minamino kanade=南奏
kinugasa (kancolle)=衣笠
leaf (pokemon)=叶（口袋妖怪）
arashio (kancolle)=阿拉盐 (Kanko)
matsuno osomatsu=松树
kujou sara=抱怨
sendai kai ni (kancolle)=在仙台会议上
matsuno ichimatsu=松木方格
lusamine (pokemon)=lusamine（口袋妖怪）
ushiwakamaru (fate)=牛若丸（命运）
artoria pendragon (lancer alter) (fate)=artoria pendragon (lancer alter) (fate)
karin (bunny) (blue archive)=karin（兔子）（蓝色存档）
yorha no. 9 type s=约哈号9型
kamiya nao=头发和脑
mimura kanako=三村加奈子
nishizumi shiho=西泉洋步
hanyuu=羽生
felicia (vampire)=费利西亚（吸血鬼）
robin (fire emblem) (female)=知更鸟（火焰纹章）（女）
monkey d. luffy=猴子 D.路飞
ayanami (kancolle)=绫波
rensouhou-kun=人搜后-困
itadori yuuji=虎杖紧急情况
satou kazuma=砂糖和真
misumi nagisa=凪咲美澄
isuzu (kancolle)=五十铃
souseiseki=总成绩
watatsuki no yorihime=棉花依姬
sendai hakurei no miko=仙台是泥制巫女
agano (kancolle)=盟约（kancolle）
etna (disgaea)=埃特纳 (disgaea)
harukawa maki=春川卷
symboli rudolf (umamusume)=鲁道夫 (umamusume) 符号
princess king boo=布公主
japanese crested ibis (kemono friends)=日本朱鹮（kemono 朋友）
i-class destroyer=i级驱逐舰
omaru polka=波尔卡圆点
mei (overwatch)=美（守望先锋）
musashi kai ni (kancolle)=前往武藏会
leafa=薪水
monokuma=单熊
hojo karen=辅助的
angelina (arknights)=安吉丽娜（明日方舟）
ohara mari=大原玛丽
rosehip (girls und panzer)=玫瑰果（少女与装甲）
levi (shingeki no kyojin)=艾薇（进击的巨人）
northern white-faced owl (kemono friends)=北方白脸猫头鹰（kemono 朋友）
kirigaya suguha=马上桐谷
gengar=耿鬼
satono diamond (umamusume)=satono钻石(umamusume)
fukumaru koito=福丸爱和
tokisaki kurumi=时崎狂三
libeccio (kancolle)=西南风（kancolle）
morpeko (full)=morpeko（全）
saren (princess connect!)=saren（公主连结！）
camilla (fire emblem)=卡米拉（火焰纹章）
skyla (pokemon)=skyla（口袋妖怪）
takodachi (ninomae ina'nis)=另一片树林
eternity larva=永恒的幼虫
hirasawa ui=平泽衣
ushiromiya ange=内殿天使
edward elric=爱德华艾尔利克
tsumiki mikan=积木橘子
oshida (girls und panzer)=押田（少女与装甲）
funami yui=船见唯
gamagoori ira=伤心
kaeya (genshin impact)=变化（Genshin Impacter CT）
mikazuki munechika=三日月宗近
bremerton (scorching-hot training) (azur lane)=布雷默顿（灼热训练）（碧蓝航线）
hatsune miku (append)=初音未来 (A pen d)
kagura (gintama)=神乐（银魂）
kawakaze (kancolle)=川风
asakura toru=朝仓拿
artoria pendragon (alter swimsuit rider) (fate)=阿尔托莉雅·潘德拉贡（alter swimsuit rider）（fate）
kasugano sakura=春日的樱花
honolulu (azur lane)=火奴鲁鲁（碧蓝航线）
ramlethal valentine=致命情人节
chibi usa=赤壁兔
fushiguro megumi=伏黑惠
tohru (maidragon)=tohru (maidragon)
widowmaker (overwatch)=寡妇制造者（守望先锋）
purple heart=紫心
vegeta=素食
leonardo da vinci (fate)=列奥纳多·达·芬奇（精灵）
endeavor (boku no hero academia)=努力（我的英雄学院）
palutena=帕卢托的
isonami (kancolle)=矶波
skadi the corrupting heart (arknights)=腐蚀之心斯卡蒂（明日方舟）
shirase sakuya=让我知道
francesca lucchini=弗朗西斯卡卢基尼
specter (arknights)=幽灵（明日方舟）
kamui gakupo=神威是库波
ringo (touhou)=林戈（欲望）
oguri cap (umamusume)=小栗浦 (Uma Musume)
tina branford=蒂娜布兰福德
cure peace=治愈和平
ashiya douman (fate)=以赛亚·杜马（胖子）
yang guifei (fate)=杨贵妃 (fate)
kishibe rohan=岸边露伴
kashuu kiyomitsu=歌本清光
matsuno choromatsu=松树的长老松树
nian (arknights)=年（明日方舟）
albedo (genshin impact)=Albed（Genshin Impacter CT）
martha (fate)=玛莎（命运）
ymir (shingeki no kyojin)=y unr（进击的巨人）
artoria pendragon (swimsuit ruler) (fate)=artoria pendragon（泳装尺）（fate）
silver fox (kemono friends)=银狐（kemono 朋友）
bloop (gawr gura)=泡泡
uiharu kazari=早春
katori (kancolle)=香取 (Kanakle)
fujibayashi kyou=今天的藤林
hino rei=一天的例子
kemomimi-chan (naga u)=Kemomimi-chan（长）
myoukou (kancolle)=没有扣 (看错哦来了)
enemy aircraft (kancolle)=敌机（kancolle）
lisa (genshin impact)=Isa（Genshin Impacter CT）
tashkent (kancolle)=塔什干（卡纳克勒）
yuffie kisaragi=尤菲是个婊子
mihono bourbon (umamusume)=mihono波旁威士忌（umamusume）
jessie (pokemon)=杰西（口袋妖怪）
midna=没有任何
noire (neptune series)=黑色（海王星系列）
konjiki no yami=金色黑暗
murakumo kai ni (kancolle)=前往村云海（观光）
le malin (azur lane)=邪恶的人（碧蓝航线）
koharu (blue archive)=小春
sonozaki shion=园崎紫苑
nanasaki ai=七爱
jeanne d'arc (swimsuit archer) (fate)=圣女贞德（泳装射手）（命运）
jervis (kancolle)=杰维斯 (kancolle)
elsa (frozen)=艾尔莎（冰冻的）
helena blavatsky (fate)=海伦娜布拉瓦茨基（命运）
grey wolf (kemono friends)=灰太狼（kemono 朋友）
yuri lowell=尤里洛厄尔
marie antoinette (fate)=玛丽·安托瓦内特（命运）
roronoa zoro=罗罗诺亚索隆
fujiwara chika=藤原地下室
mayano top gun (umamusume)=玛雅壮志凌云 (Umamasume)
bayonetta=刺刀
ezo red fox (kemono friends)=虾夷红狐狸（kemono 朋友）
tsukikage yuri=由里月影
scathach skadi (fate)=scathach skadi（命运）
yaoyorozu momo=八百万桃
ragna the bloodedge=血刃拉格纳
popuko=短的
jeanne d'arc alter (ver. shinjuku 1999) (fate)=圣女贞德 (ver. shinjuku 1999) (fate)
higashi setsuna=东刹那
furutaka (kancolle)=古鹰
osakabe-hime (fate)=Osakabe - 姬（命运）
kamio misuzu=神尾美铃
mysterious heroine x alter (fate)=神秘的女主角 x 改变（命运）
momosuzu nene=桃铃宁宁
bulma=布尔玛
arch bishop (ragnarok online)=大主教（诸神黄昏在线）
elesa (pokemon)=艾尔莎（口袋妖怪）
komi shouko=包括证据
takamaki anne=高卷安妮
tiki (fire emblem)=tiki（火徽）
furukawa nagisa=古川渚
aris (blue archive)=阿里斯（蓝色档案）
nishi kinuyo=西绢代
saria (arknights)=萨里亚（明日方舟）
sonic the hedgehog=刺猬索尼克
sakura futaba=樱双叶
artoria caster (fate)=阿尔托利亚施法者（命运）
matsuno todomatsu=东都松中松
konno junko=现在纯子
charlotte dunois=夏洛特杜努瓦
madotsuki=带窗
mamiya (kancolle)=间宫 (Kanakle)
jean pierre polnareff=让·皮埃尔·波尔纳雷夫
hayashimo (kancolle)=林太（勘光）
hoshi syoko=星库
failure penguin=失败的企鹅
byleth (fire emblem) (male)=比雷丝（火焰纹章）（男）
aru (blue archive)=aru（蓝色存档）
yamato-no-kami yasusada=山tono头发很容易
little red riding hood (grimm)=小红帽（格林）
lucifer (helltaker)=路西法（地狱征服者）
tatsumi kanji=辰巳心
natsume rin=林夏目
kris (pokemon)=克里斯（口袋妖怪）
kicchou yachie=吉祥八惠
kamina (ttgl)=壁炉 (ttgl)
oshawott=奥沙沃特
sakuma mayu=眉间佐久间
bridget (guilty gear)=布里奇特（罪恶装备）
ark royal (kancolle)=阿拉克皇家 (Kanakle)
tsukioka kogane=月冈小金
yoshikawa chinatsu=吉川千佳
hoshiguma (arknights)=Hosiguma（方舟之夜）
ranma-chan=然妈-产
morino rinze=冲洗
yuno (hidamari sketch)=热水（Hidamari 的家庭 tch）
elin=电力
kamoi (kancolle)=坎科尔
lize helesta=赫勒斯塔联赛
roll (mega man)=滚（洛克人）
nekomusume=猫女
m4a1 (girls' frontline)=m4a1（少女前线）
alice margatroid (pc-98)=爱丽丝·玛格特罗 (pc-98)
abigail williams (swimsuit foreigner) (fate)=阿比盖尔威廉姆斯（泳装外国人）（命运）
tsukumo benben=津云奔奔
ryu (street fighter)=ryu（街头霸王）
reiuji utsuho (bird)=Reiwuji Utsuho（小路）
kurokoma saki=黑色的前面
kino makoto=木真相
an-94 (girls' frontline)=an-94（少女前线）
irys (hololive)=鸢尾花 (hololive)
dido (azur lane)=黛朵（碧蓝航线）
yukishiro honoka=穗香雪城
silver (pokemon)=银（口袋妖怪）
kuwayama chiyuki=躺下
noelle (genshin impact)=诺艾尔（原神冲击）
umikaze (kancolle)=海风
komano aunn=另一方面
suletta mercury=水银袜
tamura yuri=田村百合
theresa apocalypse=特蕾莎启示录
vodka (umamusume)=Vodification (乌玛娘)
wattson (apex legends)=瓦特森（顶点传奇）
reze (chainsaw man)=reze（电锯人）
myoudouin itsuki=谜之总动员伊月
marina (splatoon)=码头 (splatoon)
okita souji alter (fate)=醒来，清洁，一只手（命运）
little boy admiral (kancolle)=小男孩海军上将 (kancolle)
elio (pokemon)=elio（口袋妖怪）
kaguya luna=露娜和也
slime (genshin impact)=粘液（genshin impact）
joseph joestar (old)=约瑟夫·乔斯达（旧）
hagikaze (kancolle)=萩风格
kasumi kai ni (kancolle)=在霞会（Kanko）
hoshino (blue archive)=星野（蓝色存档）
bruno bucciarati=布鲁诺布加拉提
cagliostro (granblue fantasy)=卡里奥斯特罗（碧蓝幻想）
koyanskaya (fate)=koian（命运）
bianca (pokemon)=白色（口袋妖怪）
totoki airi=十点爱里
oreki houtarou=历史 奉太郎
mimikyu=咪咪久
scorbunny=小兔兔
prisma illya=棱镜伊利亚
natsuki subaru=菜月昴
android 21=机器人 21
shouhou (kancolle)=售后 (看错哦来了)
haramura nodoka=能登原村
oomuro sakurako=大室樱子
blanc (neptune series)=blanc（海王星系列）
g11 (girls' frontline)=g11（少女前线）
higuchi kaede=樋口枫
himemori luna=非记忆
gilles de rais (caster) (fate)=gilles de rais (caster) (命运)
sengoku nadeko=战国 na deco
tsurumaru kuninaga=国永鹤丸
tokiko (touhou)=地方（东方）
beidou (genshin impact)=米道 (Genshin Impa CT)
riesz=时髦的
ike (fire emblem)=ike（火焰纹章）
etorofu (kancolle)=择捉
m4 sopmod ii (girls' frontline)=m4 sopmod ii（少女前线）
marianne von edmund=埃德蒙的玛丽安
nishida satono=西田理乃
tohno akiha=远野明夏
fletcher (kancolle)=弗莱彻 (kancolle)
altera (fate)=改变（做）
miyamoto musashi (swimsuit berserker) (fate)=宫本武藏（泳装狂战士）（命运）
su-san=苏珊
ninomiya asuka=二宫明日香
kitasan black (umamusume)=Kita-san 背（Uma Musume）
natori sana=名取沙那
akizuki ryo=秋月郎
todoroki shouto=吼
sasaki chie=智慧佐佐木
st ar-15 (girls' frontline)=ST AR-15（少女前线）
schwarz (arknights)=schwarz（明日方舟）
diana cavendish=戴安娜·卡文迪许
nepgear=电子设备
arashi (kancolle)=岚
atalanta (fate)=亚特兰大（女）
kadotani anzu=角谷庵
kagamihara nadeshiko=各务原抚子
kudamaki tsukasa=神卷司
alisa ilinichina amiella=阿丽莎·伊利尼奇娜·阿米拉
kirin (armor)=做（盔甲）
enemy lifebuoy (kancolle)=敌人救生圈 (kancolle)
blue poison (arknights)=蓝毒（明日方舟）
fairy knight tristan (fate)=妖精骑士特里斯坦（命运）
hourai doll=娃娃
araragi koyomi=阿良良木历美
daidouji tomoyo=我的朋友同时
honma meiko=真正的薙月经
murasaki shikibu (fate)=紫式部（法塔赫）
sunazuka akira=砂冢明
cure marine=治愈海洋
piers (pokemon)=码头（口袋妖怪）
sailor mercury=水手汞
hachikuji mayoi=八九寺失传
kuma (persona 4)=和（角色 4）
ranni the witch=兰尼女巫
kasane teto=泪姨
maikaze (kancolle)=舞风
siege (arknights)=围攻（明日方舟）
z23 (azur lane)=z23（碧蓝航线）
gyro zeppeli=飞艇周围
namazuo toushirou=鲶鱼敏郎
minna-dietlinde wilcke=minna-dietlinde wilcke
colorado (kancolle)=科罗拉多州（kancolle）
teireida mai=普通米饭
tokitarou (fate)=和鬼太郎（命运）
frederica bernkastel=弗雷德里卡贝恩卡斯特尔
ooshio (kancolle)=ooshio (kancolle)
kero=令人讨厌
sobble=啜泣
hop (pokemon)=跳（口袋妖怪）
hakui koyori=白大衣小依
bulbasaur=球龙
ivan karelin=伊万·卡列林
sonya (kill me baby)=索尼娅（杀了我宝贝）
naegi makoto=苗木诚
robin (fire emblem) (male)=知更鸟（火焰纹章）（男）
seele vollerei=灵魂丰满
oyashio (kancolle)=亲潮（观光）
hoshino fumina=明星句
touhoku kiritan=东北桐谷
kirijou mitsuru=蒙蒙
richelieu (kancolle)=黎塞留 (kancolle)
caren hortensia=绣球花
kousaka reina=身高或例子
honebami toushirou=吃骨头的敏郎
hibiki (blue archive)=hibiki（蓝色档案）
silica=二氧化硅
maebara keiichi=前原总 1
sona (league of legends)=索娜（英雄联盟）
snivy=鼻涕
selen tatsuki=田月仙
furutani himawari=向日葵古谷
tohsaka tokiomi=和时臣坂
alpaca suri (kemono friends)=Al Paka Suri (Beast f Divorce ds)
wraith (apex legends)=幽灵（顶点传说）
amanogawa kirara=银河基拉拉
shantae=山台
nagi (kannagi)=凪（眼）
midare toushirou=狂暴的俊郎
baltimore (azur lane)=巴尔的摩（碧蓝航线）
ciel (tsukihime)=夏尔（月姬）
eurasian eagle owl (kemono friends)=欧亚雕鸮（kemono 朋友）
kanroji mitsuri=甘露寺不钓鱼
hasumi (blue archive)=莲见（蓝色存档）
medea (fate)=平均（女孩）
asagumo (kancolle)=晨蛛
igarashi futaba (shiromanta)=五十岚双叶（白蝠鲼）
monika (doki doki literature club)=monika（心跳文学部）
oikawa shizuku=及川滴
ta-class battleship=ta级战列舰
nagatoro hayase=长瀞太瘦了
boo (mario)=嘘（马里奥）
anila (granblue fantasy)=阿妮拉（碧蓝幻想）
pipimi=撒尿
gladion (pokemon)=高兴（口袋妖怪）
modeus (helltaker)=modeus（地狱征服者）
assam (girls und panzer)=阿萨姆（少女与装甲）
chitose (kancolle)=坎科尔
ru-class battleship=ru级战列舰
sanji (one piece)=山治（一件）
haniyasushin keiki=哈年津
yanfei (genshin impact)=燕飞 (跟室内impact)
tamaki iroha=戒指颜色是
white mage=白魔法师
kazama iroha=风间色
kururugi suzaku=枢木朱雀
abe nana=但看
sento isuzu=圣五十铃
zeta (granblue fantasy)=zeta（碧蓝幻想）
m16a1 (girls' frontline)=m16a1（少女前线）
yukinoshita yukino=在雪下
rydia (ff4)=莉迪亚 (ff4)
james (pokemon)=詹姆斯（口袋妖怪）
green (pokemon)=绿色（口袋妖怪）
shidare hotaru=流泪的萤火虫
marie (girls und panzer)=玛丽（少女与装甲）
kamado tanjirou=灶门炭治郎
victor (pokemon)=胜利者（口袋妖怪）
mikuma (kancolle)=说话（kancolle）
saniwa (touken ranbu)=Koba（刀剑乱舞）
kusanagi motoko=草薙元子
mutsuki (blue archive)=睦月
shihouin yoruichi=Shiho Inn Yoruichi酒店
yuigahama yui=由比滨由由
kohaku (tsukihime)=琥珀（月姬）
zara (azur lane)=zara（碧蓝航线）
rias gremory=化妆师
i-26 (kancolle)=i-26 (kancolle)
emperor penguin (kemono friends)=帝企鹅 (kemono friends)
artoria pendragon (alter swimsuit rider) (second ascension) (fate)=artoria pendragon (alter swimsuit rider) (二次再临) (fate)
chikuma (kancolle)=千曲
haru urara (umamusume)=Haru Urara（Uma Musume）
commander (girls' frontline)=指挥官（少女前线）
jaguar (kemono friends)=美洲虎（kemono 朋友）
luigi=路易吉
hatsushimo (kancolle)=初霜
minamoto sakura=源樱
tsuruya=鹤屋
fumizuki (kancolle)=文月
high priest (ragnarok online)=大祭司（诸神黄昏在线）
hatsukaze (kancolle)=第一风
sailor venus=水手维纳斯
momozono love=桃园之恋
boudica (fate)=布迪卡（仙女）
iris (pokemon)=虹膜（口袋妖怪）
lucas (pokemon)=卢卡斯（口袋妖怪）
umbreon=伞兵
yui (angel beats!)=yui（天使节拍！）
tharja (fire emblem)=火徽
pod (nier automata)=pod（不是自动机）
niijima makoto=新岛诚
princess daisy=雏菊公主
irida (pokemon)=输入（口袋妖怪）
frankenstein's monster (fate)=弗兰肯斯坦的怪物（命运）
sylveon=西尔维翁
shiina yuika=椎名由香
huang baoling=黄宝玲
rotom phone=手机
nu-13=13号
fubuki kai ni (kancolle)=在暴风雪派对上
mizuno ai=爱水
elira pendora=埃莉拉潘多拉
hawks (boku no hero academia)=Ha wks（我的英雄学院）
leona heidern=利昂娜·海登
nemoto hina=深灰色
kawashima momo=川岛桃
yin (darker than black)=阴（比黑色更暗）
tsukuyomi shirabe=月读研究
rita rossweisse=丽塔·罗斯维瑟
squirtle=喷水
ashido mina=芦户美奈
tamamo cross (umamusume)=Tamamo c Ross（乌玛娘）
yuzuki choco=结月巧克力
dusk (arknights)=黄昏（明日方舟）
rex (xenoblade)=雷克斯 (xenoblade)
fubuki (one-punch man)=fubuki（一拳超人）
enkidu (fate)=enkity（吃）
izumi-no-kami kanesada=和泉无毛兼定
sailor mars=水手火星
minamoto no raikou (swimsuit lancer) (fate)=Minamoto no Rekou (泳装Lancer) (Torn)
kashino (azur lane)=赌场（碧蓝航线）
higashiyama kobeni=东山小红
littorio (kancolle)=利托里奥 (kancolle)
rebecca (cyberpunk)=丽贝卡（赛博朋克）
slaine troyard=斯莱恩特罗亚德
jumpy dumpty=神经质的矮胖子
armin arlert=阿明阿勒特
haro=哈啰
yamashiro (azur lane)=山城（阿修罗·安妮）
joutouguu mayumi=神宫麻由美
chongyun (genshin impact)=冲晕 (跟室内impact)
passionlip (fate)=passionlip（命运）
kako (kancolle)=怎么样（kancolle）
zara (kancolle)=Zara (卡纳克勒)
hibiki (cheerleader) (blue archive)=hibiki（啦啦队长）（蓝色档案）
berserker (fate/zero)=狂战士（命运/零）
guido mista=吉多米斯塔
nowaki (kancolle)=野分
xuangzang sanzang (fate)=许肮脏三藏 (fate)
watatsuki no toyohime=丰姬与棉花
glaceon=冰川
hoshimiya ichigo=星宫一护
hayasui (kancolle)=便宜
hisakawa hayate=久川疾风
carpaccio (girls und panzer)=生牛肉片（女孩和坦克）
kotonoha akane=琴叶茜
karna (fate)=做（撕裂）
sabrina (pokemon)=萨布丽娜（口袋妖怪）
eishin flash (umamusume)=Eishin fash (Uma Musume)
cure sunshine=治疗阳光
katou asuka=加藤明日香
johnston (kancolle)=约翰斯顿（kancolle）
angel (kof)=天使
caenis (fate)=泥（命运）
ange katrina=这是卡特里娜飓风
hisakawa nagi=久川凪
cyndaquil=辛达奎尔
tateyama ayano=立山文雄
pharah (overwatch)=法拉（守望先锋）
kyouka (princess connect!)=kyouka（公主连结！）
tsunade (naruto)=领带（火影忍者）
bede (pokemon)=祈祷（宠物小精灵）
oribe yasuna=Oribe 和沙子
chi-chi (dragon ball)=七七（七龙珠）
america (hetalia)=美国（黑塔利亚）
cure beauty=治愈美丽
azura (fire emblem)=阿祖拉（火焰纹章）
fukuzawa yumi=福泽由美
nakamura yuri=中村百合
inui toko=好喝
kureiji ollie=吴维修哎呀
uryuu ryuunosuke=雨龙龙之介
xingqiu (genshin impact)=星球 (跟室内impact)
yuuki mikan=有纪吃东西
magical mirai miku=魔法 l 未来未来
medb (fate)=折磨（胖）
tokino sora=时间天空
tomoe hotaru=巴萤火虫
medjed (fate)=medjed（命运）
suzuhara lulu=铃原
reines el-melloi archisorte=皇后区埃尔梅洛伊拱门
inuyama aoi=犬山蓝
katsuragi misato=葛城美里
eve (elsword)=前夕（艾索德）
katou megumi=加藤惠
rachel alucard=雷切尔·阿卡德
kuchiki rukia=朽木露琪亚
millia rage=成千上万的人
tsukumo sana=Tsukumo Sana
cure blossom=治愈开花
tsurumaki maki=鹤卷缠绕
mochizuki (kancolle)=望月
hoshikawa sara=星川板
osaki amana=向前甜蜜
moogle=或许
takagi-san=高木先生
hifumi (blue archive)=日文
kazanari tsubasa=风吹动翅膀
serizawa asahi=芹泽旭
sora (kingdom hearts)=索拉（王国之心）
kongou kai ni (kancolle)=在混合派对（Kanko）
arjuna (fate)=阿俊（胖子）
miyamizu mitsuha=宫水三叶
subaru nakajima=中岛昴
akali=阿卡利
nanachi (made in abyss)=nanachi（深渊制造）
yuuki setsuna (love live!)=yuuki setsuna (love live!)
charmander=魔术师
estellise sidos heurassein=estellise sidos heurassein
tepig=支撑
scathach (swimsuit assassin) (fate)=泳装刺客(fate)
bibi (tokoyami towa)=薇薇 (Towa Darkness)
rosaria (genshin impact)=罗莎莉亚 (Genshin Impacter CT)
winry rockbell=温莉摇铃
sanageyama uzu=Sanage涡流山
bowser=鲍泽
kos-mos=冲压清洗
kars (jojo)=卡尔斯（法官）
tada riina=多田里奈
kishinami hakuno (female)=Hiroshi Kishinami 的 (Femae)
rabbit yukine=兔子雪音
albedo (overlord)=反照率（霸主）
popplio=罂粟花
pearl (splatoon)=珍珠 (splatoon)
kugisaki nobara=钉崎的玫瑰
hayakawa aki=早川秋天
horikawa kunihiro=堀川邦弘
niwatari kutaka=我要你想要
kaneki ken=金木票
abigail williams (traveling outfit) (fate)=阿比盖尔·威廉姆斯（旅行装）（命运）
prinz eugen (unfading smile) (azur lane)=欧根王子（不褪色的微笑）（碧蓝航线）
eyjafjalla (arknights)=明日方舟
twin turbo (umamusume)=双涡轮增压（umamusume）
kamikita komari=上北有麻烦
sorceress (dragon's crown)=女术士（龙之冠）
komaki manaka=小卷真中
arisugawa natsuha=有栖川夏
makaino ririmu=马凯莉莉姆
nursery rhyme (fate)=童谣（命运）
roma (kancolle)=罗马 (kancolle)
uzaki hana=宇崎花
cure black=治愈黑色
clarisse (granblue fantasy)=克拉丽丝（碧蓝幻想）
espeon=间谍
kazagumo (kancolle)=风云
frisk (undertale)=新鲜（轻描淡写）
sonoda chiyoko=就在地面旁边
mizunashi akari=没有水灯
ushiromiya maria=内殿玛丽亚
ib (ib)=一一）
kitashirakawa tamako=北白川多摩湖
ferry (granblue fantasy)=渡轮（碧蓝幻想）
mitake ran=御岳跑
violet evergarden=紫罗兰永恒花园
miorine rembran=蓝莓
king hassan (fate)=哈桑国王（命运）
tsukumo yatsuhashi=八桥月茂
momota kaito=与凯百田
marth (fire emblem)=马尔斯（火焰纹章）
yoroizuka mizore=夜冢雨夹雪
tanaka mamimi=胖子
tsushima (kancolle)=对马
suzukaze aoba=青叶铃风
mari (blue archive)=mari（蓝色档案）
cure march=治愈行军
haruna kai ni (kancolle)=在春季会议上（Kanko）
kooh=酷
takeba yukari=她抬头
takanami (kancolle)=高浪
vikala (granblue fantasy)=维卡拉（碧蓝幻想）
kitazawa shiho=北泽四步
raphtalia=拉夫塔利耶
komiya kaho=小宫佳帆
reiner braun=纯棕色
yuri plisetsky=尤里普利塞茨基
taneshima popura=种岛白杨
intrepid (kancolle)=Interepid (Kanakle)
kozakura marry=小樱结婚
akitsushima (kancolle)=秋津岛
cure happy=治愈快乐
lucoa (maidragon)=卢科亚（maidragon）
momo velia deviluke=momo velia deviluke
shiroko (swimsuit) (blue archive)=白子（泳装）（蓝色存档）
miyu (blue archive)=miyu（蓝色存档）
sucy manbavaran=烂漫巴瓦兰
sailor jupiter=水手木星
grookey=古怪的
jill valentine=吉尔情人节
meowth=喵喵
nate (pokemon)=内特（口袋妖怪）
yotsuba alice=四叶眼
hina ichigo=雏一护
inoue orihime=井上织姬
manabe nodoka=教育野田
kujou karen=抱怨
oyama mahiro=小山雅博
saotome alto=早乙女
cure melody=治愈旋律
son gohan=损失大米
shirayuki hime=白雪公主
araragi karen=阿良良木花莲
karina lyle=卡琳娜律
meltryllis (swimsuit lancer) (first ascension) (fate)=meltryllis（泳装lancer）（初升）（命运）
cheshire (azur lane)=柴郡（碧蓝航线）
iizunamaru megumu=饭纲惠
miss cloud=云小姐
japan (hetalia)=日本（黑塔利亚）
elaina (majo no tabitabi)=Ea No（魔女之旅）
danua=疼痛
saitama (one-punch man)=埼玉（一拳超人）
nakano itsuki=中间的茨木
toudou shimako=藤堂志满子
kayneth el-melloi archibald=凯奈斯·艾尔梅洛·阿奇博尔德
vaporeon=汽化龙
ichigo (darling in the franxx)=ichigo (darling in the franxx)
nonomi (blue archive)=nonomi（蓝色档案）
alphonse elric=阿尔方斯·埃里克
okazaki yumemi=冈崎梦美
xiangling (genshin impact)=响铃 (跟室内impact)
kula diamond=吃钻石
airfield princess=机场公主
baiken=不是
isabelle (animal crossing)=伊莎贝尔（动物之森）
yorha type a no. 2=yorha 输入编号2个
florence nightingale (trick or treatment) (fate)=florence nightingale (trick or treatment) (命运)
may (guilty gear)=可能（罪恶装备）
kino (kino no tabi)=树（树的旅程）
jigglypuff=泡芙
fujisaki chihiro=藤崎千寻
united kingdom (hetalia)=英国（黑塔利亚）
cu chulainn alter (fate)=cu chulainn alter（命运）
tenkyuu chimata=商店关门
ichihara nina=市原妮娜
kiriya aoi=雾和蓝色
anjou naruko=安城鸣子
amagi (kancolle)=天城（Kankale）
uehara ayumu=上原散步
hisui (tsukihime)=翡翠（月姬）
mioda ibuki=三田伊吹
agnes digital (umamusume)=agnes digital（umamusume）
okabe rintarou=沃尔伦太郎
sawa azusa=泽梓
arthur pendragon (fate)=亚瑟潘德拉贡（命运）
astolfo (sailor paladin) (fate)=阿斯托尔福（水手圣骑士）（女孩）
zidane tribal=齐达内三连冠
yuna (ff10)=尤娜 (ff10)
assassin (fate/zero)=刺客（命运/零）
oktavia von seckendorff=奥克塔维亚·冯·塞肯多夫
yuuki (sao)=有纪（星）
commandant teste (kancolle)=指挥官测试 (kancolle)
torchic=火炬
aragaki ayase=新垣绫濑
celestia ludenberg=塞莱斯蒂娅·鲁登堡
kinu (kancolle)=电影院（kancolle）
seiun sky (umamusume)=星云天空（Uma Musume）
fairy knight gawain (fate)=妖精骑士高文（命运）
sephiroth=质素
miia (monster musume)=Miia (mon s hands r daughter)
len (tsukihime)=母鸡（月姬）
suomi (girls' frontline)=芬兰（少女前线）
tohno shiki=和 h 的公式
shindou takuto=震动节拍
yamagumo (kancolle)=山云（观光）
keith goodman=基思·古德曼
lion (kemono friends)=狮子（kemono 朋友）
micaiah (fire emblem)=micaiah（火焰纹章）
misaka imouto=御坂妹妹
merlin (fate)=梅林（命运）
hikawa hina=照顾好你自己
cheren (pokemon)=黑色（口袋妖怪）
nakano ichika=定位于
fairy knight lancelot (fate)=妖精骑士兰斯洛特（命运）
lenna charlotte tycoon=莱娜夏洛特大亨
lala satalin deviluke=拉拉·斯大林·德鲁克
miyamoto musashi (swimsuit berserker) (second ascension) (fate)=宫本武藏（泳装狂战士）（二次再临）（命运）
goh (pokemon)=goh（口袋妖怪）
aisha landar=艾莎伦德
doujima nanako=堂岛7个
bernadetta von varley=贝尔纳黛塔·冯·瓦莱
euryale (fate)=euryale（命运）
lulu (league of legends)=露露（英雄联盟）
slime (dragon quest)=史莱姆（勇者斗恶龙）
kousaka kyousuke=高香京介
aquila (kancolle)=鹰（kancolle）
kurokawa eren=艾伦·黑川
hotarumaru=萤火虫圈
hammann (azur lane)=哈曼（碧蓝航线）
sakuragi mano=樱木麻之
moona hoshinova=武星新星
sucrose (genshin impact)=蔗糖（原神影响）
type 95 (girls' frontline)=95式（少女前线）
hilichurl (genshin impact)=hilichurl（原神冲击）
mordred (memories at trifas) (fate)=mordred（trifas的回忆）（命运）
kasaki nozomi=可能的目的地希望
star platinum=星铂金
narancia ghirga=橙色吉尔加
racing miku=赛车未来
grass wonder (umamusume)=草奇迹 (umamusume)
sasaki saku=来自佐佐木
tenjouin asuka=领队明日香
godzilla=哥斯拉
ro635 (girls' frontline)=ro635（少女前线）
cleveland (azur lane)=克利夫兰（碧蓝航线）
lyria (granblue fantasy)=lyria（碧蓝幻想）
ako (blue archive)=我（蓝色存档）
sakurajima mai=樱岛米
claude von riegan=克劳德·冯·里根
mukai takumi=对面拓海
marie rose=粉红玛丽
okumura haru=奥村春
kohinata miho=三浦小日向
vira (granblue fantasy)=维拉（碧蓝幻想）
graf zeppelin (azur lane)=格拉夫齐柏林飞艇（碧蓝航线）
osaki tenka=添加
steven stone=史蒂文斯通
maizono sayaka=舞园沙耶加
kazano hiori=风的hiori
sugiura ayano=杉浦文美
lux (league of legends)=勒克斯（英雄联盟）
seiren (suite precure)=seiren (suite precure)
nibutani shinka=进化成水煮猪肉
lei lei=雷雷
jingei (kancolle)=快鲸
kotonoha aoi=蓝色字
hikawa sayo=照顾你
hayasaka ai=早坂爱
platinum (arknights)=白金（明日方舟）
faris scherwiz=法里斯舍维兹
garnet til alexandros xvii=石榴石 tel alexandros hvii
nyarlathotep (nyaruko-san)=Nyarotep（Nyaruko-san）
jirou kyouka=次郎强化
ifrit (arknights)=ifrit（明日方舟）
pramanix (arknights)=pramanix（明日方舟）
hatsuharu (kancolle)=早春
kamisato ayato=上里绫
dante (devil may cry)=但丁（鬼泣）
annie leonhardt=安妮莱昂哈特
nenohi (kancolle)=儿童节（Kanko）
momoe nagisa=百江渚
nekomusume (gegege no kitarou 6)=娘娘 (GeGeGe no Kitaro 6)
matsumoto rangiku=松本乱菊
chiyoda (kancolle)=坎科尔
aozaki aoko=青崎青子
hatoba tsugu=下一个码头
ceobe (arknights)=ceobe（明日方舟）
diona (genshin impact)=diona (原神冲击)
sakura chiyo=樱千代
nia (blade) (xenoblade)=nia（刀片）（异种刀片）
yuuki (princess connect!)=yuuki（公主连结！）
shinano (azur lane)=信浓（碧蓝航线）
alice zuberg=爱丽丝祖贝格
aino megumi=爱的恩典
aki (girls und panzer)=aki（少女与装甲）
lopunny=低调的
ogata chieri=绪方知理
suou momoko=须王桃子
shizuka rin=安静的林
nadia la arwall=纳迪亚·拉瓦尔
trunks (dragon ball)=树干（龙珠）
chibi miku=赤壁未来
cure sunny=治愈晴天
anna (frozen)=安娜（冰冻的）
mega man (character)=洛克人（角色）
blaze (arknights)=大火（明日方舟）
takane lui=缝合路易斯
nagato (azur lane)=长门（碧蓝航线）
ten'ou haruka=天皇遥
guts (berserk)=胆量（狂暴）
furudo erika=富尔多埃里卡
kisaragi shintarou=如月慎太郎
murata himeko=村田姬子
allister (pokemon)=阿利斯特（口袋妖怪）
cure white=治白
octoling girl=八角女孩
ayane (doa)=绫音（祈祷）
miyanaga saki=宫永目的地
kanbaru suruga=坎巴尔确实
alisa (girls und panzer)=艾丽莎（少女与装甲）
cu chulainn (caster) (fate)=cu chulainn (caster) (命运)
yagen toushirou=烧研俊郎
rimuru tempest=rimuru tempe st
luoxiaohei=罗小黑
cerberus (helltaker)=塞伯鲁斯（地狱征服者）
laura bodewig=劳拉博德维格
alastor (shakugan no shana)=啊s和r
eva 02=伊娃02
chikorita=这是一辆车
hiyou (kancolle)=Hi有 (看错哦来了)
priest (ragnarok online)=牧师（诸神黄昏在线）
magical ruby=神奇的红宝石
roy (fire emblem)=罗伊（火焰纹章）
leafeon=情人
kasumigaoka utaha=霞丘之歌
curren chan (umamusume)=粗如人颤 (U妈木素么)
monomi (danganronpa)=Monomi（弹丸论破）
dimitri alexandre blaiddyd=迪米特里亚历山大狼人
bradamante (fate)=布拉达曼特（妖精）
lucy heartfilia=露西哈特菲利亚
cecilia alcott=塞西莉亚奥尔科特
arare (kancolle)=冰雹
yumehara nozomi=梦原希美
maou (maoyuu)=大魔王（毛宇）
kondou taeko=困惑的妙子
mikazuki (kancolle)=新月
matikane tannhauser (umamusume)=matikane tannhauser (umamusume)
garchomp=鹰嘴豆
yokoyama nao=横山直
tanikaze (kancolle)=谷风
tsurumaki kokoro=鹤卷心
arona (blue archive)=阿罗纳（蓝色档案）
bianca (dq5)=白色 (dq5)
samuel b. roberts (kancolle)=塞缪尔湾罗伯茨 (kancolle)
taihou (enraptured companion) (azur lane)=太后 (enraptured companion) (A族人lane)
murasame kai ni (kancolle)=在村雨派对上
sagiri (kancolle)=纱雾（kancolle）
zabaniyya (housamo)=扎巴尼亚 (husamo)
dorothea arnault=多萝西娅阿尔诺
himejima akeno=姬岛黎明
matsuwa (kancolle)=坎科尔
akashi (azur lane)=明石（碧蓝航线）
nanami kento=七海票和
sirius (azure horizons) (azur lane)=天狼星（蔚蓝海平线）（碧蓝航线）
nanao yuriko=百合子
silence (arknights)=沉默（明日方舟）
flareon=火炬
shirabe ako=调查赤子
reinforce zwei=加强两个
takoluka=护符
jouga maya=乔加玛雅人
maria cadenzavna eve=玛丽亚·卡扎夫娜·伊芙
kirishima touka=雾岛传送
yui (princess connect!)=yui（公主连结！）
asahina mirai=朝比奈未来
justice (helltaker)=正义（地狱终结者）
zero (mega man)=零（洛克人）
inumuta houka=饮用粉
iori (blue archive)=iori（蓝色存档）
iroha (samurai spirits)=颜色是（武士精神）
air groove (umamusume)=气槽（umamusume）
pit (kid icarus)=坑（小伊卡洛斯）
diego brando=迭戈白兰度
revy (black lagoon)=雷维（黑色泻湖）
angela balzac=安吉拉·巴尔扎克
izumi mei=泉名
rainbow mika=彩虹米卡
lambdadelta=拉姆达德尔塔
izayoi aki=秋天
corrin (fire emblem) (male)=Corrin（火焰纹章）（男）
sado (kancolle)=佐渡
zara (poolside coincidence) (azur lane)=zara（池畔巧合）（碧蓝航线）
narita brian (umamusume)=成田布赖恩（Uma Musume）
hornet (kancolle)=大黄蜂 (kancolle)
cosmog=宇宙
kiss-shot acerola-orion heart-under-blade=kiss-shot 西印度樱桃-猎户座心脏下刀片
braixen=烩
asakaze (kancolle)=传播（kancolle）
takasaki yuu=高崎优
anegasaki nene=姊崎宁宁
rosmontis (arknights)=罗斯蒙蒂斯（明日方舟）
goldenglow (arknights)=金光（明日方舟）
mohammed avdol=穆罕默德·阿夫多
elphelt valentine=情人节礼物
prinny=普利尼
lord el-melloi ii=领主埃尔梅罗二世
boa hancock=蟒蛇汉考克
yumi (senran kagura)=弓（战争神乐）
yamada elf=山田精灵
yuuki juudai=有机的
takamori aiko=高森惠顾
yunyun (konosuba)=进口（Konosuba）
yamagishi fuuka=山岸风化
pichu=皮丘
mudkip=泥浆
brown bear (kemono friends)=棕熊（kemono 朋友）
kira yoshikage=吉良义影
harukaze (kancolle)=春风
kisaragi (azur lane)=如月（碧蓝航线）
mumei (kabaneri)=无名（卡巴内瑞）
litten=左边
araragi tsukihi=阿良良木
kamukura izuru=他挖了他的鼻子
andira (granblue fantasy)=安迪拉（碧蓝幻想）
sakawa (kancolle)=放（cancolle）
hau (pokemon)=豪（口袋妖怪）
usada hikaru=宇佐田闪耀
kaiou michiru=海王
clumsy nun (diva)=笨拙的修女（天后）
kuki shinobu=干忍
makoto (street fighter)=真琴（街头霸王）
cure moonlight=治愈月光
mysterious heroine x (fate)=谜之女主角x（fate）
jeanne d'arc alter (avenger) (third ascension) (fate)=圣女贞德 (复仇者) (第三次升天) (命运)
amagi (azur lane)=天城（碧蓝航线）
momoi (blue archive)=momoi（蓝色档案）
scathach (piercing bunny) (fate)=穿孔兔（命运）
kohinata miku=小日向未来
midori (blue archive)=midori（蓝色存档）
rx-78-2=RX-78-2
toon link=卡通链接
female saniwa (touken ranbu)=Femae Koba（剑乱舞）
takeda harumi (shiromanta)=武田晴美（白蝠鲼）
caitlyn (league of legends)=凯特琳（英雄联盟）
female protagonist (pokemon go)=女主角（精灵宝可梦GO）
tennouji rina=天王寺里奈
garry (ib)=加里（一）
koyama yuzu=小山柚子
sawamura spencer eriri=泽村笔背绘梨里
vert (neptune series)=vert（海王星系列）
king halo (umamusume)=国王光环 (Umamasume)
lucy (cyberpunk)=露西（赛博朋克）
jeanne d'arc (third ascension) (fate)=圣女贞德（第三次升天）（命运）
calem (pokemon)=口袋妖怪
natsu megumi=夏日恩典
y'shtola rhul=y'shtola rhul
kobayakawa sae=小早川佐江
eva 01=伊娃01
yamabuki inori=山吹祈祷
humboldt penguin (kemono friends)=洪堡企鹅（kemono 朋友）
admiral graf spee (azur lane)=施佩伯爵海军上将（碧蓝航线）
yuuki haru=有机泉
shampoo (ranma 1/2)=洗发水（乱马 1/2）
cure peach=治愈桃
jack-o' valentine=杰克情人节
atago (stunning speedster) (azur lane)=爱宕（极速赛车）（碧蓝航线）
hinatsuru ai=雏鹤爱
takei hisa=武井久
brynhildr (fate)=布伦希尔德（命运）
hino akane (idolmaster)=日野茜（偶像大师）
edmond dantes (fate)=爱德蒙·唐太斯（命运）
sonia nevermind=索尼娅没关系
yamato (one piece)=大和（一件）
tsuchinoko (kemono friends)=土野子 (Beast f Divorce ds)
yuni (princess connect!)=yuni（公主连结！）
ichikawa hinana=市川成本7
kiki (majo no takkyuubin)=设备（琪琪的送货服务）
tanned cirno=晒黑的奇诺
moose (kemono friends)=驼鹿（kemono 朋友）
ryoumen sukuna (jujutsu kaisen)=两边少（魔线）
guzma (pokemon)=guzma（口袋妖怪）
chrom (fire emblem)=铬（火焰纹章）
crewmate (among us)=船员（我们中间）
celes chere=切莱斯切尔
pannacotta fugo=panna cotta fugo
senji muramasa (fate)=战时村正（法塔赫）
narita taishin (umamusume)=地震成田（Uma Musume）
aki rosenthal=相同的罗森塔尔
takakura himari=高仓日成
ichigo hitofuri=草莓奶昔
super creek (umamusume)=超级溪 (umamusume)
pyra (pro swimmer) (xenoblade)=pyra (pro swimmer) (xenoblade)
maruyama aya=丸山文美
izuna (blue archive)=izuna（蓝色存档）
sajo yukimi=佐藤幸见
elizabeth bathory (brave) (fate)=伊丽莎白·巴托里（勇敢）（命运）
saber alter (ver. shinjuku 1999) (fate)=saber alter (ver. shinjuku 1999) (fate)
arataki itto=新泷它
abigail williams (third ascension) (fate)=阿比盖尔威廉姆斯（第三次提升）（命运）
m200 (girls' frontline)=m200（少女前线）
meer campbell=更多坎贝尔
matoi (pso2)=当（严重）
ibuki (street fighter)=伊吹（街头霸王）
milla maxwell=米拉麦克斯韦
natalia (idolmaster)=娜塔莉亚（偶像大师）
zooey (granblue fantasy)=柔伊（碧蓝幻想）
feater (arknights)=feater（明日方舟）
pochita (chainsaw man)=电锯人
elysia (honkai impact)=elysia（崩坏冲击）
konpaku youki=灵魂容器
yamamura sadako=山村贞子
ri-class heavy cruiser=里级重巡洋舰
roon (azur lane)=roon（碧蓝航线）
senkawa chihiro=千川千寻
acerola (pokemon)=针叶樱桃（口袋妖怪）
aoba moca=青叶摩卡
ara haan=哦是的
beatrix (granblue fantasy)=碧翠丝（碧蓝幻想）
g36 (girls' frontline)=g36（少女前线）
irene (arknights)=艾琳（明日方舟）
ene (kagerou project)=Ene（Kagerou P Roger CT）
gawain (fate)=高文（命运）
oomori yuuko=大份裕子
galo thymos=公鸡愤怒
neru (blue archive)=黑色（蓝色存档）
nearl (arknights)=nearl（明日方舟）
pneuma (xenoblade)=pneuma（异种刀片）
helltaker (character)=地狱终结者（角色）
mikko (girls und panzer)=mikko（少女与装甲）
bb (swimsuit mooncancer) (second ascension) (fate)=bb（泳装月癌）（第二次提升）（命运）
toutetsu yuuma=游真彻
harime nui=大哈里姆
nelson (kancolle)=纳尔逊 (kancolle)
abigail williams (swimsuit foreigner) (third ascension) (fate)=阿比盖尔威廉姆斯（泳装外国人）（第三次提升）（命运）
yumeko (touhou)=与么KO (投后)
trish una=崔西
nagara (kancolle)=镇（卡纳克勒）
merlin (fate/prototype)=梅林（命运/原型）
sora ginko=天空银杏
ingrid brandl galatea=英格丽·布兰德·加拉蒂亚
tomimi (arknights)=tomimi（明日方舟）
lisbeth (sao)=莉丝贝丝（sao）
azusa (blue archive)=azusa（蓝色存档）
pomu rainpuff=pomu rainpuff
iori rinko=安凛子
chocobo=陆行鸟
rita mordio=丽塔比特
kaine (nier)=凯恩（尼尔）
st. louis (luxurious wheels) (azur lane)=英石。路易斯（豪华轮子）（碧蓝航线）
naoe riki=是你
mifune miyu=三船美优
yuudachi (azur lane)=Yuudachi（蔚蓝小鹿）
swire (arknights)=太古（明日方舟）
eirika (fire emblem)=eirika（火焰纹章）
bazett fraga mcremitz=巴泽特弗拉加麦克雷米茨
dead master=死去的主人
kido tsubomi=亮度芽
rena erindel=雷纳埃林德尔
matoba risa=马托巴里沙
nakasu kasumi=中须霞
platelet (hataraku saibou)=patet（工作细胞）
trafalgar law=特拉法加法
shoukaku (azur lane)=翔鹤（碧蓝航线）
manya (dq4)=成人 (dq4)
sailor saturn=水手土星
ingo (pokemon)=ingo（口袋妖怪）
vi (league of legends)=vi（英雄联盟）
eunectes (arknights)=eunectes（明日方舟）
oberon (fate)=奥伯伦（命运）
lina inverse=丽娜反转
gokotai=个人
finana ryugu=菲娜刘宇
meisho doto (umamusume)=Sights Todo（乌玛娘）
shishio chris=Shishio Ch.
jill stingray=吉尔黄貂鱼
meltryllis (swimsuit lancer) (second ascension) (fate)=meltryllis（泳装lancer）（二次再临）（fate）
oshino ougi=推风扇
enemy naval mine (kancolle)=敌人的水雷 (kancolle)
hunter (bloodborne)=猎人（血源性）
master 3 (housamo)=大师 3 (housamo)
himeno (chainsaw man)=霸权（Shinzo Min）
kirlia=基利亚
hirose koichi=广濑古一
mary (ib)=玛丽（一）
isobe noriko=矶部的自私
shokudaikiri mitsutada=烛台切割秘密
jeanne d'arc (swimsuit archer) (first ascension) (fate)=圣女贞德（泳装射手）（初升）（命运）
shun (blue archive)=顺（蓝色存档）
okita sougo=起床相互
regina (dokidoki! precure)=里贾纳（Doki Doki！p Lecle）
natori (kancolle)=名取（kancolle）
yamper=安培
sussurro (arknights)=sussurro（明日方舟）
carmilla (fate)=卡米拉（仙女）
small-clawed otter (kemono friends)=小爪水獭（kemono 朋友）
meta knight=元骑士
vane (granblue fantasy)=风向标（碧蓝幻想）
white rabbit (alice in wonderland)=白兔（爱丽丝梦游仙境）
akaboshi koume=小目赤星
projekt red (arknights)=红色计划（明日方舟）
wakan tanka=坦克之歌
kuzuha (nijisanji)=葛叶（二吉三好）
hagoromo lala=羽衣拉拉
reisen (touhou bougetsushou)=冷战（我们的防月所）
kogitsunemaru=小吉常丸
paul bunyan (fate)=保罗班扬（命运）
nitocris (swimsuit assassin) (fate)=尼托克里斯（泳装刺客）（命运）
lavinia whateley (fate)=拉维尼娅·惠特利（命运）
cure heart=治愈心脏
haruno haruka=春野遥
fujimaru ritsuka (male) (polar chaldea uniform)=藤丸一香（前）
yusa kozue=小津佑佐
satanichia kurumizawa mcdowell=satanichia kurumizawa 麦克道尔
i-13 (kancolle)=i-13 (kancolle)
leonardo da vinci (rider) (fate)=leonardo da vinci (rider) (妖精)
kazami yuuka (pc-98)=风见宝 (pc-98)
sf-a2 miki=宁静米奇
kikuzuki (kancolle)=菊月
roboco-san=机器人小哥
elesis (elsword)=elesis（艾索德）
cure rhythm=治愈节奏
yumeno himiko=梦姬子
sirius (scorching-hot seirios) (azur lane)=sirius (scorching-hot seirios) (碧蓝航线)
naomi (girls und panzer)=娜奥米（少女与装甲）
toudou yurika=百合科
tomioka giyuu=富冈义夫
ryugasaki rene=龙崎玲奈
t-head trainer=丁头教练
alina gray=阿丽娜格雷
nikka edvardine katajainen=妮卡·爱德华丁·卡贾宁
elizabeth bathory (first ascension) (fate)=伊丽莎白巴托里（第一次提升）（命运）
nikaidou saki=二阶堂目的地
mash kyrielight (swimsuit of perpetual summer)=mash kyrielight（永夏泳装）
dinergate (girls' frontline)=食堂（少女前线）
erika (pokemon)=埃里卡（口袋妖怪）
okinami (kancolle)=离岸海浪
zuikaku (azur lane)=瑞鹤 (Asur Ane)
perth (kancolle)=珀斯（坎纳克）
froggy nun (diva)=青蛙修女 (女主角)
gorou (genshin impact)=五郎（Genshin Impacter CT）
platinum the trinity=白金三位一体
utsumi erice=内海爱丽丝
kariya masaki=织物保护
iruma miu=入间美宇
sister cleaire=克莱尔姐妹
isolated island oni=孤岛鬼
fukuda haru=福田春
akita neru=秋田睡眠
lance (pokemon)=长矛（口袋妖怪）
shinonome nano=纳米东云
error musume=你女儿
stheno (fate)=吃吃）
tanya degurechaff=问 degurechaff
mejiro dober (umamusume)=mejiro 好 (umamusume)
ui (blue archive)=ui（蓝色存档）
satake minako=佐竹美奈子
takumi (fire emblem)=拓海（火焰纹章）
thoma (genshin impact)=托马（原神冲击）
irako (kancolle)=里科 (Kinkle)
artoria caster (second ascension) (fate)=阿尔托利亚施法者（二次升天）（命运）
kirisawa juuzou (character)=雾泽十藏 (chara c hand r)
morgana (persona 5)=莫甘娜（第五人）
rhea (fire emblem)=土卫五（火焰纹章）
sei shounagon (fate)=SEI受那個on (fate)
ogata hyakunosuke=绪方百之介
fujimaru ritsuka (female) (polar chaldea uniform)=藤丸一香（女前）
otokura yuuki=大量有机
izayoi liko=我会很开心
yukoku kiriko=雪国切子
black heart=黑心
takimoto hifumi=泷本日文
yuri (doki doki literature club)=百合
fine motion (umamusume)=精细动作（umamusume）
admire vega (umamusume)=参见 Ad，Vega（Uma Musume）
grecale (kancolle)=希腊语（kancolle）
shibuya kanon=涩谷佳能
semiramis (fate)=塞米拉米斯（命运）
wu zetian (fate)=武则天 (fate)
getou suguru=夏季油
arle nadja=阿尔勒纳贾
ryuzaki kaoru=辰崎薰
hyakumantenbara salome=万店玫瑰saome
puru-see (hoshizuki (seigetsu))=Purusee (星月 (Seigetsu))
ibuki tsubasa=呼吸的翅膀
mochizuki anna=望月安娜
ousaka shizuku=樱坂雫
bb (swimsuit mooncancer) (third ascension) (fate)=bb（泳装mooncancer）（第三次提升）（命运）
le malin (listless lapin) (azur lane)=le malin（无精打采的拉宾）（碧蓝航线）
mysterious heroine x alter (first ascension) (fate)=神秘的女主角 x 改变（第一次提升）（命运）
shinshuu maru (kancolle)=信州丸
asbel lhant=阿斯贝尔作曲
nakagawa natsuki=中川奈月
g41 (girls' frontline)=g41（少女前线）
sage (dq3)=圣人 (dq3)
kawakami mai=川上我
eris greyrat=你会变成灰老鼠
utage (arknights)=Utage（方舟之夜）
sand cat (kemono friends)=沙猫（kemono 朋友）
mika (blue archive)=米卡（蓝色档案）
himekawa yuki=雪姬川
kishinami (kancolle)=岸波
alena (dq4)=阿莲娜（儿子）
smart falcon (umamusume)=聪明的猎鹰 (umamusume)
cheria barnes=切里亚巴恩斯
kasuga maru (kancolle)=春日丸
yatadera narumi=八田寺鸣海
mordred (swimsuit rider) (fate)=莫德雷德（泳装骑士）（命运）
sakata kintoki (fate)=坂田金时（命运）
golden snub-nosed monkey (kemono friends)=金丝猴（kemono 朋友）
hina (swimsuit) (blue archive)=hina（泳装）（蓝色存档）
tiki (adult) (fire emblem)=tiki（成人）（火焰纹章）
amami rantarou=甜蜜乱太郎
hasegawa kobato=长谷川小畑
hoshimiya kate=星宫
sugimoto saichi=杉本才一
fukawa touko=深川东子
yozora mel=夜空
saijo juri=有天赋的女人
yuel (granblue fantasy)=yuel（碧蓝幻想）
nekomiya hinata=猫宫日向
igarashi kyoko=五十岚恭子
maya kai ni (kancolle)=到摩亚凯（观光）
tomoe gozen (swimsuit saber) (fate)=tomoe gozen（泳装军刀）（命运）
blue poison (shoal beat) (arknights)=蓝色毒药（浅滩节拍）（明日方舟）
hasumi (gym uniform) (blue archive)=莲实（健身房制服）（蓝色档案）
kayoko (blue archive)=佳代子（蓝色存档）
uehara himari=上原日成
roxy migurdia=洛克希米古迪亚
saren (summer) (princess connect!)=saren（夏天）（公主连结！）
jean bart (azur lane)=让·巴特（碧蓝航线）
katagiri sanae=片桐早苗
queen elizabeth (azur lane)=伊丽莎白女王（碧蓝航线）
9a-91 (girls' frontline)=9a-91（少女前线）
rengoku kyoujurou=炼狱恭十郎
keebo=哪个
whislash (arknights)=挥鞭（明日方舟）
vampy=吸血鬼
naganami kai ni (kancolle)=去长波会（Kanko）
jeanne d'arc (granblue fantasy)=圣女贞德（碧蓝幻想）
matikanefukukitaru (umamusume)=Machikane Fukukitaru（Uma Musume）
sweep tosho (umamusume)=苏绘本（Uma Musume）
toyokawa fuka=丰川不可能
kiyohime (swimsuit lancer) (fate)=清姬（命运）
karyl (summer) (princess connect!)=karyl (summer) (公主连结!)
razor (genshin impact)=剃刀（原神冲击）
siro (dennou shoujo youtuber siro)=siro（每日少女youtuber siro）
tsuyuri kanao=Rusato Nao
negev (girls' frontline)=negev（少女前线）
eldridge (azur lane)=埃尔德里奇（碧蓝航线）
midway princess=中途公主
matsubara kanon=松原佳音
magallan (arknights)=麦哲伦（明日方舟）
ijichi nijika=在维修土地上拥有自己的房子
okusawa misaki=奥泽美咲
tiki (young) (fire emblem)=tiki（年轻）（火徽）
spicy nun (diva)=辣修女（天后）
hayasaka mirei=早坂美玲
jeanne d'arc (swimsuit archer) (second ascension) (fate)=圣女贞德（泳装弓箭手）（第二次提升）（命运）
udagawa tomoe=你分发了tomoe
shirasagi chisato=白鹭千里
la pluma (arknights)=羽毛（明日方舟）
sato shin=里进
takamiya rion=高宫理音
crypto (apex legends)=加密（顶点传说）
uzuki sayaka=漩涡沙耶加
kumada masaru=讨厌胜
